fecha,Adelantos,Documentos,Hipotecarios,Prendarios,Personales,Tarjetas,Otros,TOTAL
2025-10-15,8849763,19265473,5511642,5599460,18285550,19466216,4583954,81562058
2025-10-14,9071131,19243064,5484623,5580059,18251225,19968952,4607995,82207049
2025-10-13,9022095,19412524,5459852,5587518,18223657,19703279,4617245,82026170
2025-10-09,8807782,19314801,5439520,5608875,18258521,20590161,4617617,82637277
2025-10-08,8734162,19118728,5417411,5621905,18199125,20896778,4650479,82638588
2025-10-07,8653281,18960844,5389684,5626453,18168844,21471979,4643011,82914096
2025-10-06,8551691,18940545,5359319,5621013,18143171,21343599,4645037,82604375
2025-10-03,8227885,18879658,5341080,5643013,18137256,21755607,4648526,82633025
2025-10-02,8223251,18749601,5316405,5630800,18115018,21697607,4638231,82370913
2025-10-01,8312291,18695257,5295008,5617815,18094258,21558973,4640709,82214311
2025-09-30,8024914,18720953,5266658,5547829,18134809,21094448,4584642,81374253
2025-09-29,7859063,18683693,5242807,5553800,18144042,21311839,4498304,81293548
2025-09-26,7626902,18719058,5217231,5522867,18121220,20738881,4387628,80333787
2025-09-25,7733891,18666066,5191424,5487206,18107270,20624341,4382451,80192649
2025-09-24,7830583,18639884,5161209,5473735,18084901,20452154,4396875,80039341
2025-09-23,7907314,18616672,5135391,5468454,18067614,20347880,4397043,79940368
2025-09-22,7839648,18777701,5116515,5462576,18040668,19949460,4419616,79606184
2025-09-19,7717877,18849994,5095607,5467609,18003872,19646613,4435090,79216662
2025-09-18,7724704,18788944,5066898,5448320,17975360,19571895,4405976,78982097
2025-09-17,7739778,18772842,5042837,5447912,17948269,19404884,4423771,78780293
2025-09-16,7876620,18762770,5019536,5445395,17922790,19298694,4447235,78773040
2025-09-15,7858075,18893197,5000668,5435775,17914253,18966824,4476113,78544905
2025-09-12,7709237,19020178,4982126,5428032,17882136,18749477,4506412,78277598
2025-09-11,7837545,18967743,4958867,5416476,17850666,18587036,4539208,78157541
2025-09-10,7965719,18959004,4933813,5410793,17822607,18554278,4555203,78201417
2025-09-09,7916764,18912331,4911924,5419821,17893710,18723494,4603986,78382030
2025-09-08,7873088,18988212,4889802,5413800,17852293,18846675,4634387,78498257
2025-09-05,7714533,18972188,4872152,5418137,17812504,19332235,4654739,78776488
2025-09-04,7574645,18828298,4846242,5400022,17778427,19813715,4638608,78879957
2025-09-03,7566119,18716950,4817102,5368542,17788023,20354776,4669179,79280691
2025-09-02,7781335,18701491,4792978,5362290,17742080,20766696,4693868,79840738
2025-09-01,7522412,18909295,4768028,5338367,17734967,20760987,4659841,79693897
2025-08-29,7446875,18955976,4746874,5316879,17721163,21122860,4608617,79919244
2025-08-28,7755513,18861624,4720736,5258949,17730652,20954332,4548272,79830078
2025-08-27,7892057,18746565,4690546,5249512,17704728,20721075,4465322,79469805
2025-08-26,7973589,18725025,4667254,5230249,17676248,20497486,4483011,79252862
2025-08-25,8056857,18845507,4642120,5224336,17650019,20656194,4448053,79523086
2025-08-22,7967188,18879887,4623129,5213705,17617491,20262084,4452946,79016430
2025-08-21,8112966,18829974,4600395,5192022,17592280,20047297,4398178,78773112
2025-08-20,8080502,18859596,4575098,5170136,17549330,19806613,4415828,78457103
2025-08-19,8191983,18816404,4551641,5163201,17510913,19743916,4453413,78431471
2025-08-18,8223343,19030337,4532155,5155323,17466174,19146367,4446780,78000479
2025-08-14,7946686,19113174,4516882,5153092,17402948,19001615,4368682,77503079
2025-08-13,8360921,18970352,4486117,5139337,17363148,19025446,4399946,77745267
2025-08-12,8400653,18965083,4464437,5119068,17319305,19185751,4401992,77856289
2025-08-11,8450439,19033771,4439734,5121558,17277106,18568707,4421796,77313111
2025-08-08,8218626,18941037,4420826,5130260,17285461,18914745,4416270,77327225
2025-08-07,8123772,18831387,4392231,5130380,17219780,19550052,4462710,77710312
2025-08-06,8197300,18898215,4369793,5132904,17169607,19962310,4450627,78180756
2025-08-05,8273055,18775938,4352066,5143618,17149722,20437783,4451223,78583405
2025-08-04,8221445,18763256,4332978,5160160,17095098,20520909,4462458,78556304
2025-08-01,8209765,18779544,4311194,5151555,17026015,20768309,4414584,78660966
2025-07-31,8074633,18622952,4300909,5136105,17034067,20844115,4379780,78392561
2025-07-30,8368163,18668166,4277264,4998140,17019608,20610105,4431294,78372740
2025-07-29,8382526,18485186,4251600,4997043,16984935,20417040,4440826,77959156
2025-07-28,8494655,18518164,4233206,4973167,16951440,20105114,4397682,77673428
2025-07-25,8504962,18616497,4214641,4988837,16886659,19638105,4383560,77233261
2025-07-24,8779626,18550992,4193369,4973412,16840767,19151991,4339306,76829463
2025-07-23,8924243,18483404,4169823,4957998,16799923,18926211,4318473,76580075
2025-07-22,9173161,18396849,4149282,4953361,16756140,18784977,4308001,76521771
2025-07-21,9365605,18514962,4128399,4950095,16692095,18329396,4316669,76297221
2025-07-18,9304723,18549533,4112724,4948854,16639700,18140668,4321362,76017564
2025-07-17,9322890,18455240,4092704,4937764,16599712,18006375,4322612,75737297
2025-07-16,9401078,18378451,4067324,4933963,16559073,17885027,4358250,75583166
2025-07-15,9348725,18361836,4043620,4928210,16525191,17746842,4345453,75299877
2025-07-14,9281547,18462928,4025645,4920149,16486530,17384334,4342941,74904074
2025-07-11,9070216,18470424,4007095,4920891,16421206,17246926,4339285,74476043
2025-07-10,9046782,18437746,3982799,4887442,16391014,17110604,4373927,74230314
2025-07-08,8740536,18297517,3959017,4890036,16440709,17340667,4349440,74017922
2025-07-07,8889035,18341259,3933464,4890873,16396286,17616385,4279591,74346893
2025-07-04,8706328,18304186,3914560,4921201,16350747,18200735,4183252,74581009
2025-07-03,8465279,18116312,3888722,4913570,16337213,18636060,4189504,74546660
2025-07-02,8501157,18002860,3862656,4914007,16333490,19317822,4180455,75112447
2025-07-01,8623411,18009533,3844776,4909250,16337335,19560310,4153669,75438284
2025-06-30,8468765,18216128,3832411,4883378,16312390,20126941,4095941,75935954
2025-06-27,8296699,18017068,3803099,4834306,16320156,19495119,3993639,74760086
2025-06-26,8421048,17825609,3774640,4793651,16307918,19348719,3936402,74407987
2025-06-25,8550073,17693441,3759267,4774995,16286838,19094168,3911598,74070380
2025-06-24,8713243,17546460,3735498,4758490,16259683,18927385,3816649,73757408
2025-06-23,8663210,17778634,3717763,4745202,16231562,18362419,3743601,73242391
2025-06-19,8639830,17724554,3658431,4729940,16139162,18733181,3702370,73327468
2025-06-18,8500849,17640715,3633403,4702189,16101407,17839426,3682519,72100508
2025-06-17,8513663,17768862,3611159,4698680,16066104,17233132,3712031,71603631
2025-06-13,8148658,17796341,3598008,4692946,16021719,17065999,3738903,71062574
2025-06-12,8217545,17724341,3573929,4676171,15985939,16977284,3732990,70888199
2025-06-11,8322375,17662285,3546096,4669736,15935152,16960251,3721313,70817208
2025-06-10,8186926,17548039,3523272,4655115,15916735,17427029,3727638,70984754
2025-06-09,7947649,17613063,3499172,4663467,15962888,17189793,3763720,70639752
2025-06-06,7625127,17551284,3484356,4668567,15888783,17421413,3763856,70403386
2025-06-05,7684577,17441359,3461588,4670709,15839813,18418695,3770569,71287310
2025-06-04,7509319,17329639,3437056,4663270,15838077,18742770,3790957,71311088
2025-06-03,7508898,17228141,3420599,4650249,15794502,19363906,3792626,71758921
2025-06-02,7472065,17400115,3402140,4637329,15786575,18969883,3749430,71417537
2025-05-30,7351484,17555220,3389616,4620775,15725004,19211525,3686800,71540424
2025-05-29,7521954,17447524,3364168,4587394,15721422,19350161,3500402,71493025
2025-05-28,7542170,17369814,3334411,4546416,15685427,19184105,3441662,71104005
2025-05-27,7542092,17287750,3313533,4528523,15650026,19007151,3428224,70757299
2025-05-26,7664264,17401105,3294856,4510643,15612379,18548680,3402308,70434235
2025-05-23,7444173,17411367,3269542,4496055,15556589,18302706,3391603,69872035
2025-05-22,7498602,17336697,3248292,4474444,15524743,18171261,3381643,69635682
2025-05-21,7479123,17312421,3226888,4458045,15476046,17953695,3364986,69271204
2025-05-20,7416157,17342225,3210363,4439760,15425152,17855895,3371507,69061059
2025-05-19,7482454,17391348,3189106,4425991,15381620,17371624,3400025,68642168
2025-05-16,7447245,17449930,3170083,4411616,15325798,17101927,3383967,68290566
2025-05-15,7418391,17412284,3149515,4396196,15277227,16960083,3418816,68032512
2025-05-14,7413735,17379783,3130452,4381984,15229070,16728283,3426710,67690017
2025-05-13,7586093,17336554,3111383,4371338,15174255,16815789,3436905,67832317
2025-05-12,7530269,17469106,3096479,4354136,15122511,16590258,3439950,67602709
2025-05-09,7340361,17402802,3079911,4357103,15128518,17183561,3413233,67905489
2025-05-08,7052539,17278554,3060035,4346345,15044492,17839573,3450702,68072240
2025-05-07,7045706,17150863,3037043,4329360,14989311,18207279,3465128,68224690
2025-05-06,7066725,17083333,3021775,4325519,14958509,18723527,3484751,68664139
2025-05-05,7098376,17238698,3006276,4324083,14907706,18788022,3471582,68834743
2025-04-30,6734704,17296396,2991127,4329475,14820958,18578974,3339767,68091401
2025-04-29,7050361,17211547,2955977,4220437,14808537,18601717,3285393,68133969
2025-04-28,7236612,17233888,2926290,4176289,14776046,18081051,3195830,67626006
2025-04-25,7022467,17300213,2904545,4152364,14701380,17806795,3190635,67078399
2025-04-24,7055201,17224200,2884493,4121040,14654563,17680359,3182554,66802410
2025-04-23,7103463,17162200,2861812,4097868,14604304,17429460,3108787,66367894
2025-04-22,7237609,17150678,2842705,4085631,14528584,17367895,3147624,66360726
2025-04-21,7034779,17327943,2823217,4070203,14474494,16858943,3131154,65720733
2025-04-16,6902927,17342184,2816138,4065958,14369202,16590979,3153752,65241140
2025-04-15,7009243,17299124,2791041,4051556,14302733,16489612,3176513,65119822
2025-04-14,6897270,17369219,2770949,4034799,14238187,16124955,3194701,64630080
2025-04-11,7028946,17337534,2752673,4026795,14164125,15952651,3178436,64441160
2025-04-10,7132956,17195990,2726929,3995871,14149986,15862794,3133569,64198095
2025-04-09,6851070,17087596,2722773,3995182,14126115,15845114,3156507,63784357
2025-04-08,6646127,16964820,2699668,3980497,14043565,16048882,3141870,63525429
2025-04-07,6537090,16969380,2682204,3933918,13970484,16400172,3180876,63674124
2025-04-04,6543398,16877936,2664561,3941804,13898521,16808856,3189625,63924701
2025-04-03,6375495,16774801,2646422,3927143,13839465,17242097,3196338,64001761
2025-04-01,6552321,16864897,2622959,3905991,13794544,17506709,3161583,64409004
2025-03-31,6338703,16890010,2603435,3833954,13713832,17425072,3097774,63902780
2025-03-28,6380044,16781406,2583653,3815273,13637385,17460681,3020560,63679002
2025-03-27,6375872,16643282,2563483,3801765,13578750,17285381,2925873,63174406
2025-03-26,6402354,16505805,2541611,3792643,13526036,16909961,2922656,62601066
2025-03-25,6286192,16571481,2524333,3775580,13461958,16229894,2914267,61763705
2025-03-21,6261303,16598031,2509455,3760640,13357293,16152057,2846512,61485291
2025-03-20,6141601,16492459,2488102,3743097,13297858,15988647,2820388,60972152
2025-03-19,6230141,16380428,2467157,3728258,13218443,15762517,2831678,60618622
2025-03-18,6240118,16216426,2452642,3722520,13155509,15539337,2812966,60139518
2025-03-17,6307586,16185873,2436767,3712732,13096649,15211439,2800449,59751495
2025-03-14,6240133,16213831,2418536,3707833,13013387,15113928,2855336,59562984
2025-03-13,6318872,16117978,2401987,3686759,12951151,15018423,2854479,59349649
2025-03-12,6576364,16089660,2380925,3675573,12897012,15000518,2843716,59463768
2025-03-11,6483622,15977410,2367505,3672217,12838288,15315444,2853997,59508483
2025-03-10,6274390,15929755,2356404,3662176,12763793,15213021,2856238,59055777
2025-03-07,5964033,15858591,2343307,3666567,12720578,16089244,2874581,59516901
2025-03-06,6061128,15743773,2326852,3654089,12674291,16662706,2878042,60000881
2025-03-05,5864331,15865439,2311142,3666335,12622994,16516106,2870455,59716802
2025-02-28,5551724,16008695,2301020,3665275,12535810,16590333,2838032,59490889
2025-02-27,5522683,15863583,2286720,3646380,12504941,16720286,2732151,59276744
2025-02-26,5653913,15778595,2263515,3615652,12470305,16406848,2664698,58853526
2025-02-25,5741413,15731278,2244910,3599038,12421357,16234088,2761963,58734047
2025-02-24,5713693,15774246,2231058,3580007,12371278,15915713,2768553,58354548
2025-02-21,5628363,15827066,2219431,3570474,12312541,15693599,2774349,58025823
2025-02-20,5512932,15767447,2203316,3543694,12263805,15491964,2773203,57556361
2025-02-19,5463594,15712850,2186449,3535681,12191737,15306949,2769646,57166906
2025-02-18,5511921,15676152,2172116,3520393,12136282,15165856,2776858,56959578
2025-02-17,5523580,15733508,2158506,3508812,12080735,14797878,2768087,56571106
2025-02-14,5409942,15784180,2149194,3508310,12000074,14589289,2767525,56208514
2025-02-13,5426663,15704666,2137224,3490707,11939322,14577733,2788291,56064606
2025-02-12,5570238,15713283,2120148,3456255,11872555,14552268,2795956,56080703
2025-02-11,5530453,15628531,2110045,3448658,11812143,14733168,2768041,56031039
2025-02-10,5463129,15672201,2097828,3447754,11737991,14539758,2780206,55738867
2025-02-07,5187206,15659901,2091170,3449480,11699742,15423750,2793578,56304827
2025-02-06,5138799,15539975,2080414,3437543,11619778,15707603,2795697,56319809
2025-02-05,5333410,15398952,2066481,3441581,11573065,16052393,2806089,56671971
2025-02-04,5323957,15329605,2058508,3440133,11510779,16485534,2812186,56960702
2025-02-03,5353845,15402568,2049739,3430805,11449018,16396150,2797939,56880064
2025-01-31,5202874,15514926,2040649,3418688,11382275,16244108,2618143,56421663
2025-01-30,5331425,15475312,2032729,3391056,11348044,16693287,2586353,56858206
2025-01-29,5322305,15413224,2018168,3377305,11301543,16510582,2547507,56490634
2025-01-28,5492356,15415680,2005439,3361550,11247036,16355960,2530087,56408108
2025-01-27,5482844,15463409,1997200,3349100,11188749,15939917,2528940,55950159
2025-01-24,5324665,15499237,1988769,3339379,11100432,15636089,2520493,55409064
2025-01-23,5261949,15402890,1979507,3328926,11045180,15487949,2513063,55019464
2025-01-22,5265691,15378261,1968264,3315921,10987743,15319986,2487534,54723400
2025-01-21,5329484,15347537,1958063,3309285,10916549,15196270,2481540,54538728
2025-01-20,5277495,15439750,1948810,3302541,10852836,14839957,2494185,54155574
2025-01-17,5264825,15514158,1937297,3290489,10757135,14620484,2500378,53884766
2025-01-16,5292148,15492324,1928935,3279786,10702849,14528987,2537211,53762240
2025-01-15,5413445,15513318,1913568,3267201,10655821,14386491,2568697,53718541
2025-01-14,5397240,15510808,1903176,3262360,10602223,14269817,2588163,53533787
2025-01-13,5530537,15650205,1892978,3257498,10544086,13936404,2593219,53404927
2025-01-10,5358051,15693824,1882733,3249632,10462125,13798275,2608767,53053407
2025-01-09,5236699,15609758,1869331,3251881,10458323,13794178,2602164,52822334
2025-01-08,5141265,15515977,1854593,3244850,10389304,13909547,2611108,52666644
2025-01-07,5179812,15493318,1847102,3239053,10325217,13978739,2615293,52678534
2025-01-06,5027748,15500435,1839422,3236832,10253342,14745599,2639464,53242842
2025-01-03,4899399,15507517,1830544,3245219,10180163,15223795,2633477,53520114
2025-01-02,4926182,15795823,1818048,3245047,10140277,15509852,2588231,54023460
2024-12-30,4675214,16015618,1813647,3230618,10102898,15685155,2468608,53991758
2024-12-27,4951287,16015781,1795487,3223185,10025809,15541401,2409564,53962514
2024-12-26,5045957,15912010,1771322,3184169,9979168,15113951,2426264,53432841
2024-12-23,4923302,15813738,1756048,3162694,9915669,14474221,2340878,52386550
2024-12-20,4798869,15711087,1727780,3141475,9844616,14226233,2337696,51787756
2024-12-19,4916217,15503635,1714453,3115792,9800351,14060048,2288935,51399431
2024-12-18,4971720,15347502,1691101,3084815,9766516,13861825,2270190,50993669
2024-12-17,4988177,15213780,1672213,3047299,9724056,13671650,2281598,50598773
2024-12-16,4928838,15214210,1650874,3030028,9705911,13309384,2267779,50107024
2024-12-13,4727172,15138346,1639393,3009973,9643108,13136514,2264469,49558975
2024-12-12,4833190,15062900,1615755,2988569,9595368,13014822,2253896,49364500
2024-12-11,5032137,15009984,1595986,2950063,9543033,13005668,2227451,49364322
2024-12-10,5109383,14950375,1582166,2936188,9493938,13153618,2171326,49396994
2024-12-09,4867138,14918737,1568277,2934017,9485403,12965874,2143992,48883438
2024-12-06,4622121,14873283,1553686,2926401,9394333,13840551,2149098,49359473
2024-12-05,4706682,14738084,1538378,2921133,9339944,13934253,2153154,49331628
2024-12-04,4667395,14632268,1521378,2915835,9297755,14102842,2143267,49280740
2024-12-03,4735550,14573921,1511742,2910029,9251424,14255155,2155563,49393384
2024-12-02,4751747,14744710,1499508,2910368,9225330,13995650,2113497,49240810
2024-11-29,4590738,14724427,1484453,2850571,9148648,14215952,2070932,49085721
2024-11-28,4607656,14624512,1471885,2863648,9119327,14248329,2012026,48947383
2024-11-27,4565929,14507581,1457524,2850062,9083269,14104724,1951081,48520170
2024-11-26,4820424,14426806,1441847,2839737,9038226,13943679,1942041,48452760
2024-11-25,4954216,14420920,1429515,2833635,8988323,13547787,1975055,48149451
2024-11-22,4835097,14411128,1419450,2827325,8923525,13317415,1977826,47711766
2024-11-21,4884911,14314879,1401570,2805798,8859563,13121501,1980714,47368936
2024-11-20,4824970,14324617,1389956,2794845,8799787,12875156,1971424,46980755
2024-11-19,4858753,14380612,1376205,2784193,8742554,12502977,1972670,46617964
2024-11-15,4693440,14409263,1366605,2768795,8691992,12368039,2016617,46314751
2024-11-14,4649177,14369457,1352782,2751021,8638057,12304791,2052360,46117645
2024-11-13,4684251,14247636,1334274,2738425,8585028,12279586,2052884,45922084
2024-11-12,4701728,14174397,1318087,2722546,8521692,12278521,2076916,45793887
2024-11-11,4734024,14203986,1307335,2709938,8465926,12220370,2067757,45709336
2024-11-08,4510370,14186729,1295085,2704563,8417882,12841267,2074444,46030340
2024-11-07,4635401,14132654,1278385,2684440,8358815,13113380,2104388,46307463
2024-11-05,4687664,14022923,1267256,2669237,8308731,13223378,2094539,46273728
2024-11-04,4778064,14006358,1253353,2664343,8278287,13247808,2114894,46343107
2024-11-01,4521812,14044715,1238087,2652713,8222913,13668287,2074580,46423107
2024-10-31,4262199,14008018,1224656,2640306,8128712,13322523,2091542,45677956
2024-10-30,4276594,13944785,1196229,2618624,8114539,13394563,2066995,45612329
2024-10-29,4380271,13868204,1183429,2594045,8074439,13232241,2018754,45351383
2024-10-28,4539345,13868992,1170208,2583322,8021461,12776413,1977724,44937465
2024-10-25,4333408,13864446,1160665,2568992,7957527,12571259,1968624,44424921
2024-10-24,4491905,13781767,1147201,2548746,7913256,12408851,1952278,44244004
2024-10-23,4559089,13722395,1135546,2533371,7872010,12252822,1967665,44042898
2024-10-22,4595169,13648522,1124456,2520374,7831469,12060880,1979179,43760049
2024-10-21,4752550,13693555,1107049,2510506,7790161,11735150,1964269,43553240
2024-10-18,4501556,13682245,1097321,2499682,7732156,11487854,1970811,42971625
2024-10-17,4537736,13594361,1086160,2484041,7687301,11338063,1987567,42715229
2024-10-16,4713484,13512547,1073223,2468147,7637292,11205477,2007143,42617313
2024-10-15,4622524,13494665,1063899,2456522,7579567,11010719,2007909,42235805
2024-10-14,4894095,13473230,1052768,2444196,7532802,10676739,1998250,42072080
2024-10-10,4576010,13421686,1042780,2436941,7453384,10486802,2004611,41422214
2024-10-09,4327231,13302460,1031612,2426229,7448758,10426127,2015971,40978388
2024-10-08,4155391,13190114,1021367,2411263,7386217,10649172,2009121,40822645
2024-10-07,4377848,13136893,1002199,2400374,7325889,11049878,2015635,41308716
2024-10-04,4363900,13086521,993879,2402374,7242687,11172077,2036448,41297886
2024-10-03,4301752,12971620,986459,2391543,7204729,11414709,2080489,41351301
2024-10-02,4308963,12831639,977313,2380493,7160287,11942778,2095463,41696936
2024-10-01,4387454,12736684,969052,2368960,7103167,11987348,2104657,41657322
2024-09-30,4287073,12789239,957072,2354035,7071385,11828922,2058280,41346006
2024-09-27,4387148,12746523,946579,2341212,7025375,11733557,1984950,41165344
2024-09-26,4539061,12636559,936843,2314651,6978999,11624817,1973520,41004450
2024-09-25,4440250,12567888,929188,2303595,6937093,11380131,1920042,40478187
2024-09-24,4487708,12516666,920778,2294783,6888670,11260702,1891453,40260760
2024-09-23,4534790,12510164,912146,2284319,6841365,10885264,1880534,39848582
2024-09-20,4362295,12493109,905820,2277731,6767656,10624010,1895017,39325638
2024-09-19,4303361,12398544,893505,2264246,6727389,10479117,1904365,38970527
2024-09-18,4344470,12305623,884917,2234924,6690473,10294210,1933522,38688139
2024-09-17,4376770,12216330,876958,2225891,6643122,10136605,1950271,38425947
2024-09-16,4460095,12256228,870743,2216066,6598364,9845298,1952114,38198908
2024-09-13,4372549,12185012,864214,2208880,6529922,9652050,1953719,37766346
2024-09-12,4445231,12086749,857762,2195095,6464611,9503268,1925411,37478127
2024-09-11,4402739,12025260,848950,2186084,6412299,9540415,1922059,37337806
2024-09-10,4447289,11970225,842108,2175116,6360598,9674459,1926932,37396727
2024-09-09,4332199,11887485,836098,2168920,6344036,9459784,1941312,36969834
2024-09-06,4179655,11781012,827494,2161522,6252979,10128138,1935770,37266570
2024-09-05,4162918,11667505,814255,2148347,6197051,10288738,1939556,37218370
2024-09-04,4173847,11543859,809150,2139526,6160136,10537949,1941532,37305999
2024-09-03,4186721,11475095,804445,2125230,6112675,10789308,1946354,37439828
2024-09-02,4264671,11507824,796663,2133437,6076836,10610342,1884186,37273959
2024-08-30,4115580,11504431,786652,2122135,6005758,10667532,1854034,37056122
2024-08-29,4126985,11346718,781946,2089376,5986947,10804943,1847999,36984914
2024-08-28,4182539,11160773,777693,2077129,5950329,10586696,1790885,36526044
2024-08-27,4189914,11105794,772151,2064253,5907974,10430453,1790479,36261018
2024-08-26,4325702,11066673,766230,2053346,5864921,10116543,1777820,35971235
2024-08-23,4242573,11025872,761996,2047118,5804391,9918719,1774930,35575599
2024-08-22,4239847,10938719,757094,2035521,5764506,9766854,1760006,35262547
2024-08-21,4357337,10875979,751866,2023991,5728093,9650762,1755655,35143683
2024-08-20,4334771,10799520,744625,2002815,5687085,9437877,1738163,34744856
2024-08-19,4407264,10764202,741457,1995268,5652672,9139561,1750422,34450846
2024-08-16,4353031,10738432,733334,1989257,5590804,8974717,1752341,34131916
2024-08-15,4324601,10657025,727808,1971272,5543631,8876632,1772456,33873425
2024-08-14,4295131,10581522,723774,1943813,5493208,8851291,1779120,33667859
2024-08-13,4354056,10459430,718023,1921289,5442259,8916635,1776566,33588258
2024-08-12,4355553,10452082,714943,1897107,5392841,8944135,1770618,33527279
2024-08-09,4220505,10405045,712992,1880732,5344952,9314833,1762890,33641949
2024-08-08,4201034,10287493,708201,1857999,5284743,9467244,1764035,33570749
2024-08-07,4177877,10178688,705824,1837051,5230320,9682411,1762429,33574600
2024-08-06,4201355,10100453,702728,1811809,5176096,9910353,1760524,33663318
2024-08-05,4364464,10056655,700370,1801969,5136585,9756300,1763069,33579412
2024-08-02,4254408,10010004,698308,1793002,5064704,10087813,1762040,33670279
2024-08-01,4267159,9930085,690281,1772910,5021464,10033174,1724985,33440058
2024-07-31,4231010,9907192,680971,1746576,4988123,9828754,1696076,33078702
2024-07-30,4279268,9877250,672349,1725321,4953209,9921398,1616380,33045175
2024-07-29,4333033,9837440,668104,1696294,4917228,9421299,1598597,32471995
2024-07-26,4403226,9801605,667892,1683363,4854989,9328640,1542229,32281944
2024-07-25,4550276,9692710,668685,1667588,4811236,9158715,1540951,32090161
2024-07-24,4445504,9601251,664139,1647824,4767203,9006014,1538420,31670355
2024-07-23,4336333,9528589,658955,1625736,4728234,8887121,1500699,31265667
2024-07-22,4420690,9526303,656555,1609444,4687239,8625216,1493172,31018619
2024-07-19,4353230,9493039,654033,1600753,4630067,8405428,1503961,30640511
2024-07-18,4336312,9362445,644486,1579307,4595505,8252700,1514113,30284868
2024-07-17,4381083,9293156,643660,1557704,4554663,8110031,1515043,30055340
2024-07-16,4448080,9218398,640418,1537743,4510917,7985666,1520962,29862184
2024-07-15,4438278,9157555,640227,1526795,4467706,7755977,1521738,29508276
2024-07-12,4226975,9134198,638754,1510909,4409361,7552928,1497462,28970587
2024-07-11,4222382,8972010,636155,1497052,4363078,7499035,1501275,28690987
2024-07-10,4042727,8898329,635575,1483648,4326314,7555759,1546323,28488675
2024-07-08,3881804,8819850,635895,1476264,4225344,7616981,1530225,28186363
2024-07-05,4079008,8699411,634819,1469575,4227088,7914430,1541914,28566245
2024-07-04,4227245,8507750,632869,1453976,4186434,8054972,1527690,28590936
2024-07-03,4174328,8341233,626875,1441005,4163817,8173236,1527235,28447729
2024-07-02,4093465,8225838,626137,1428494,4132261,8506068,1537532,28549795
2024-07-01,4564839,8176188,625332,1425804,4126957,8367526,1513765,28800411
2024-06-28,4288544,8184904,623700,1403101,4067352,8499940,1461206,28528747
2024-06-27,4391753,7869858,618958,1392856,4049318,8486899,1402325,28211967
2024-06-26,4177941,7658146,610952,1369408,4024524,8356510,1335714,27533195
2024-06-25,4060998,7493550,608457,1361279,3988053,8102044,1323395,26937776
2024-06-24,4188114,7563516,604770,1344397,3960929,7740385,1305525,26707636
2024-06-19,3923677,7514119,604856,1334269,3905602,7569667,1295820,26148010
2024-06-18,3871325,7502517,605277,1323702,3874934,7176628,1291283,25645666
2024-06-14,3717469,7452488,606698,1314023,3820277,6982325,1299836,25193116
2024-06-13,3690118,7278148,598403,1299388,3784438,6935100,1281722,24867317
2024-06-12,3753232,7187852,597884,1291126,3749133,6907379,1277505,24764111
2024-06-11,4018253,7049247,595655,1283607,3711776,7013922,1271684,24944144
2024-06-10,3848833,7012028,594604,1275405,3673371,6797051,1263284,24464576
2024-06-07,3556476,6899702,595965,1273023,3637961,7344958,1260261,24568346
2024-06-06,3576574,6746960,591568,1265448,3601335,7469699,1239568,24491152
2024-06-05,3492863,6651737,590752,1259503,3575214,7679934,1238374,24488377
2024-06-04,3486561,6551488,591949,1254987,3543619,7943740,1239262,24611606
2024-06-03,3577071,6500245,596820,1249268,3507595,7754208,1224911,24410118
2024-05-31,3459763,6539015,590213,1229676,3477557,7805160,1200878,24302262
2024-05-30,3319237,6479057,591659,1215073,3461890,7874410,1158326,24099652
2024-05-29,3308646,6437319,592380,1205877,3434032,7767652,1124142,23870048
2024-05-28,3417257,6313032,591351,1192348,3405682,7684541,1069627,23673838
2024-05-27,3529805,6275098,586022,1179360,3377837,7414191,946200,23308513
2024-05-24,3509143,6235444,587098,1167250,3336595,7236716,945951,23018197
2024-05-23,3523198,6149558,587882,1157681,3308797,7139847,928487,22795450
2024-05-22,3567102,6089617,586209,1152239,3277184,7047314,918861,22638526
2024-05-21,3516858,6006625,586043,1145454,3247468,6963981,899539,22365968
2024-05-20,3718391,5998854,587511,1138477,3216634,6719870,905776,22285513
2024-05-17,3608830,5954683,587772,1135508,3174020,6555657,904297,21920767
2024-05-16,3558971,5911129,588748,1129217,3145580,6353095,897012,21583752
2024-05-15,3634983,5877839,587753,1125089,3109731,6338777,889502,21563674
2024-05-14,3513149,5828856,588771,1123736,3079336,6399493,892232,21425573
2024-05-13,3514854,5851079,589596,1119418,3047388,6218078,887829,21228242
2024-05-10,3402776,5845222,590741,1116004,2997119,6682294,888542,21522698
2024-05-09,3232098,5752592,590781,1116037,2977342,6860676,880388,21409914
2024-05-08,3114749,5719488,591100,1114299,2954532,7021738,888031,21403937
2024-05-07,3113467,5657898,590775,1110414,2924269,7253238,882870,21532931
2024-05-06,3243051,5642714,592480,1108123,2903044,7287919,899946,21677277
2024-05-03,3150959,5586620,592913,1112476,2862507,7438301,900479,21644255
2024-05-02,3208744,5591101,593897,1112451,2847351,7357994,862692,21574230
2024-04-30,3034799,5648324,590060,1102573,2833902,7183715,851585,21244958
2024-04-29,3088208,5624044,586890,1114326,2829960,7063239,807462,21114129
2024-04-26,2948464,5626728,585810,1113832,2809262,6874907,800277,20759280
2024-04-25,2970060,5599130,584227,1107130,2793766,6774758,794490,20623561
2024-04-24,3008561,5561948,583831,1105612,2776332,6679705,796500,20512489
2024-04-23,2964520,5522162,583980,1098176,2757201,6580031,803485,20309555
2024-04-22,3008111,5536881,584398,1095949,2739404,6384136,801657,20150536
2024-04-19,2980584,5532308,584346,1098599,2712980,6280732,806123,19995672
2024-04-18,2939279,5488290,585968,1094121,2693141,6179920,810133,19790852
2024-04-17,2930174,5451969,587008,1092654,2671240,6084477,837313,19654835
2024-04-16,3008541,5418803,586822,1092622,2655398,6026543,840739,19629468
2024-04-15,3063038,5413573,587628,1092040,2639601,5834654,840465,19470999
2024-04-12,3091689,5428312,589084,1092861,2615479,5734206,846438,19398069
2024-04-11,3082128,5426317,589545,1089397,2596924,5692642,854465,19331418
2024-04-10,3035467,5397910,589846,1088506,2579943,5861589,858143,19411404
2024-04-09,2956265,5386557,590942,1089028,2575472,5961929,861145,19421338
2024-04-08,3069340,5385656,590194,1088926,2557867,6140695,866935,19699613
2024-04-05,3021226,5398400,591006,1090973,2533157,6278823,869089,19782674
2024-04-04,3186567,5369149,590509,1095582,2527738,6656411,862962,20288918
2024-04-03,3244241,5487007,591015,1096238,2514102,6492261,837202,20262066
2024-03-27,2743577,5478842,590419,1084209,2495273,6488057,819179,19699556
2024-03-26,2698398,5404413,591422,1070040,2486460,6450317,784882,19485932
2024-03-25,2741438,5356382,591953,1064381,2475574,6208027,763597,19201352
2024-03-22,2609326,5282309,591950,1059900,2455456,6052981,767467,18819389
2024-03-21,2660509,5213277,592045,1059357,2444987,5970524,780880,18721579
2024-03-20,2684485,5176397,592000,1058449,2434866,5852195,788048,18586440
2024-03-19,2675005,5110714,592525,1057062,2424132,5773662,789105,18422205
2024-03-18,2730681,5116907,593229,1052316,2412392,5516654,780183,18202362
2024-03-15,2727750,5107077,594041,1050658,2416857,5548173,789370,18233926
2024-03-14,2690500,5087309,594377,1048362,2380045,5420662,808129,18029384
2024-03-13,2724026,5053997,595777,1046903,2367311,5441488,818382,18047884
2024-03-12,2690649,5043212,597962,1043806,2352720,5530380,829887,18088616
2024-03-11,2678123,5079378,598250,1040775,2339909,5336046,834234,17906715
2024-03-08,2520218,5059235,598601,1042299,2337331,5784982,842556,18185222
2024-03-07,2613263,5025425,598522,1041566,2324666,5889642,848967,18342051
2024-03-06,2591740,4989518,599361,1040159,2313808,5964178,847344,18346108
2024-03-05,2616249,4952209,599334,1040118,2313828,6094608,849407,18465753
2024-03-04,2683491,4932047,599493,1043029,2307509,6098422,854407,18518398
2024-03-01,2726029,4961965,600174,1041446,2294172,6243379,847990,18715155
2024-02-29,2674817,4957418,599230,1030115,2300786,6175458,830839,18568663
2024-02-28,2551316,4915358,598035,1022182,2292814,6172763,799075,18351543
2024-02-27,2549211,4880311,598229,1018661,2283518,6073713,777863,18181506
2024-02-26,2609512,4878585,598126,1012072,2272591,5846864,765183,17982933
2024-02-23,2626421,4872011,600184,1006554,2254495,5684080,760432,17804177
2024-02-22,2754579,4821985,599528,995765,2244623,5617784,761125,17795389
2024-02-21,2573823,4790072,599999,992838,2236002,5536163,764601,17493498
2024-02-20,2554075,4777348,600212,989224,2226424,5473591,758294,17379168
2024-02-19,2555908,4773788,599553,987508,2217073,5320277,761589,17215696
2024-02-16,2542314,4754576,599919,981723,2200406,5219647,761357,17059942
2024-02-15,2701823,4726227,599768,977681,2187806,5232554,760319,17186178
2024-02-14,2556439,4746859,598507,975620,2175733,5162454,754536,16970148
2024-02-09,2337057,4753737,600323,973993,2155450,5462187,746683,17029430
2024-02-08,2302429,4698387,597351,972259,2142865,5632883,737599,17083773
2024-02-07,2313896,4651023,595627,967420,2130866,5686263,740249,17085344
2024-02-06,2298299,4622416,595054,965491,2121335,5861181,748753,17212529
2024-02-05,2242583,4597212,594949,964544,2120416,5859586,755714,17135004
2024-02-02,2180404,4588356,595720,967314,2106468,6074403,768112,17280777
2024-02-01,2246527,4578371,596728,966550,2098518,6000123,768406,17255223
2024-01-31,2085927,4606758,595302,954076,2099105,5915626,732591,16989385
2024-01-30,1817839,4499772,595452,956352,2094747,5893382,681888,16539432
2024-01-29,1869147,4494805,595966,957806,2090565,5709110,663652,16381051
2024-01-26,1712023,4445677,593872,955956,2076939,5536195,669301,15989963
2024-01-25,1793270,4431890,592951,958812,2066129,5457728,676056,15976836
2024-01-24,1787464,4407785,593806,958556,2057705,5382550,679551,15867417
2024-01-23,1809044,4404094,594057,959389,2050973,5331202,680815,15829574
2024-01-22,1860216,4427166,593887,962993,2042510,5279802,682048,15848622
2024-01-19,1743492,4436409,594652,962677,2031297,5105624,685164,15559315
2024-01-18,1767982,4414227,594583,964115,2024604,5031564,697214,15494289
2024-01-17,1839853,4407209,594515,963858,2011498,4959959,735873,15512765
2024-01-16,1790426,4396856,594699,965132,2005231,4907676,750818,15410838
2024-01-15,1777196,4429788,595150,967813,1998666,4762596,746411,15277620
2024-01-12,1721638,4450802,594905,968655,1988066,4660157,745960,15130183
2024-01-11,1776022,4423411,595698,968402,1980427,4594995,750592,15089547
2024-01-10,1748465,4419513,595456,967208,1973397,4598115,758017,15060171
2024-01-09,1638902,4417367,596529,969128,1976079,4722022,757566,15077593
2024-01-08,1599258,4427990,596123,969703,1969294,4817219,757651,15137238
2024-01-05,1601886,4446954,596636,979769,1959229,5068071,766359,15418904
2024-01-04,1646564,4435196,596302,976191,1964721,5202617,767090,15588681
2024-01-03,1661563,4450932,594138,989937,2010285,5393696,774598,15875149
2024-01-02,1760865,4551811,594949,989962,2013024,5270532,765714,15946857
2023-12-29,1635452,4640424,595739,971118,1964317,5383921,756105,15947076
2023-12-28,1659103,4651421,594343,968846,1955780,5368960,747689,15946142
2023-12-27,1633930,4648580,594848,961592,1952402,5301224,740685,15833261
2023-12-26,1708585,4699761,595734,955576,1948482,5096321,704790,15709249
2023-12-22,1707291,4725159,596285,954392,1940541,4902912,701917,15528497
2023-12-21,1650646,4724941,596137,948383,1938493,4816256,705070,15379926
2023-12-20,1624531,4756133,596100,943690,1935625,4733002,703593,15292674
2023-12-19,1605989,4754292,595128,941422,1932755,4700643,706640,15236869
2023-12-18,1661887,4792630,594998,939196,1929927,4501832,715161,15135631
2023-12-15,1567613,4826750,595151,938733,1925175,4462988,724140,15040550
2023-12-14,1520548,4810050,595295,936450,1922168,4440129,727367,14952007
2023-12-13,1673881,4805318,595241,933666,1921174,4460970,738098,15128348
2023-12-12,1654739,4810970,595017,931789,1916035,4633836,737831,15280217
2023-12-11,1672029,4819955,595591,930586,1912177,4560956,730693,15221987
2023-12-07,1588865,4822566,595501,930778,1907587,4752557,721466,15319320
2023-12-06,1621982,4728249,591688,927064,1901908,4794328,723412,15288631
2023-12-05,1561855,4689644,590452,926529,1905672,4910267,722039,15306458
2023-12-04,1635806,4664621,589442,926764,1903644,4960766,725640,15406683
2023-12-01,1579390,4682256,588877,924447,1900700,5050729,723009,15449408
2023-11-30,1508765,4713014,588112,915546,1907272,5084016,707814,15424539
2023-11-29,1463822,4682806,585868,913527,1899014,4995709,673049,15213795
2023-11-28,1474653,4649714,584016,909559,1895718,4962441,657468,15133569
2023-11-27,1454675,4662662,583784,905129,1891684,4834175,648314,14980423
2023-11-24,1429236,4660255,584499,897538,1883426,4699839,644969,14799762
2023-11-23,1480750,4634675,583981,895770,1878853,4639931,636748,14750708
2023-11-22,1486348,4621508,581648,890808,1874153,4552160,639167,14645792
2023-11-21,1450140,4667329,579074,889132,1869844,4350408,641789,14447716
2023-11-17,1439901,4685113,578587,890817,1860723,4343725,615476,14414342
2023-11-16,1479894,4621496,575202,889857,1861570,4250733,626923,14305675
2023-11-15,1471239,4578417,569850,885041,1854621,4259460,633328,14251956
2023-11-14,1432739,4541752,566989,883037,1849584,4244344,639875,14158320
2023-11-13,1478048,4530854,563824,879648,1843902,4131399,650997,14078672
2023-11-10,1459117,4525152,559635,875982,1834057,4048404,654074,13956421
2023-11-09,1423677,4478620,556005,875980,1833477,4021822,656371,13845952
2023-11-08,1393110,4449470,554936,872651,1826889,4060303,666527,13823886
2023-11-07,1435105,4470175,553628,869799,1822467,3984756,663801,13799731
2023-11-03,1402567,4460934,549086,871969,1812362,4381027,667177,14145122
2023-11-02,1388531,4437758,547525,869644,1821687,4413392,667925,14146462
2023-11-01,1427847,4437131,546539,859224,1811795,4513918,659238,14255692
2023-10-31,1358341,4451300,545817,855144,1818276,4656934,652132,14337944
2023-10-30,1378901,4479114,542295,853682,1810640,4547563,631150,14243345
2023-10-27,1394581,4486826,540992,855289,1807875,4498232,599094,14182889
2023-10-26,1431803,4481222,537184,853759,1802811,4437011,605311,14149101
2023-10-25,1452456,4476094,534409,852423,1798138,4349542,607244,14070306
2023-10-24,1479167,4487556,533912,850210,1793720,4300163,611587,14056315
2023-10-23,1442705,4519800,533198,847479,1790148,4108849,606596,13848775
2023-10-20,1487851,4543936,533117,844291,1779166,3986424,601673,13776458
2023-10-19,1499861,4471268,527774,842605,1775349,3918691,574540,13610088
2023-10-18,1516164,4398047,523942,837626,1766349,3812139,572964,13427231
2023-10-17,1492327,4411361,519672,830785,1758449,3592192,580942,13185728
2023-10-12,1381104,4368997,516647,824115,1746029,3534584,589931,12961407
2023-10-11,1423023,4241437,514692,822450,1735229,3487762,601715,12826308
2023-10-10,1429959,4150886,510594,819025,1726205,3528583,604150,12769402
2023-10-09,1380486,4083149,508826,818158,1717814,3430096,599615,12538144
2023-10-06,1306519,4038523,505590,815131,1706099,3636590,598101,12606553
2023-10-05,1302387,3979402,504190,813040,1698580,3714757,586999,12599355
2023-10-04,1286181,3914087,502121,813490,1696689,3763604,590287,12566459
2023-10-03,1332111,3882553,500368,809617,1689918,3890087,593462,12698116
2023-10-02,1360572,3888770,499608,786607,1695269,3803905,581202,12615933
2023-09-29,1277627,3874865,498811,802961,1692259,3845836,578284,12570643
2023-09-28,1241615,3800382,495244,800939,1679873,3839873,551919,12409845
2023-09-27,1264598,3748534,493033,792082,1673135,3760622,529766,12261770
2023-09-26,1269888,3714758,491313,786193,1664854,3737765,514407,12179178
2023-09-25,1282925,3708327,489889,782218,1657094,3634260,518590,12073303
2023-09-22,1261593,3701411,489120,779795,1647637,3549625,522069,11951250
2023-09-21,1242389,3680685,488167,778968,1639824,3503348,512926,11846307
2023-09-20,1242420,3653997,487355,777078,1634009,3449145,513648,11757652
2023-09-19,1224957,3634353,486743,775669,1622543,3402075,516471,11662811
2023-09-18,1261757,3634144,485509,776303,1611024,3296658,510861,11576256
2023-09-15,1217883,3639111,484916,774870,1595551,3262251,518778,11493360
2023-09-14,1239908,3604557,483278,772743,1583564,3231157,512783,11427990
2023-09-13,1202977,3576043,481933,770009,1569550,3219346,511534,11331392
2023-09-12,1246056,3549979,480083,764721,1557925,3252746,509670,11361180
2023-09-11,1281694,3544790,479382,760610,1543412,3231303,514361,11355552
2023-09-08,1167709,3527105,478813,759250,1535318,3350861,521146,11340202
2023-09-07,1209169,3483775,474644,757849,1531579,3417928,516397,11391341
2023-09-06,1233680,3453953,473347,755617,1528596,3556678,521188,11523059
2023-09-05,1239787,3440067,472761,754716,1529061,3652971,522696,11612059
2023-09-04,1255586,3431642,472472,755270,1527824,3667906,528685,11639385
2023-09-01,1257416,3440279,472581,754483,1533694,3749704,527063,11735220
2023-08-31,1246877,3443721,471353,749798,1537140,3700751,521592,11671232
2023-08-30,1169548,3434323,468521,745305,1530478,3691184,498728,11538087
2023-08-29,1193161,3423143,467632,742519,1531135,3658875,492485,11508950
2023-08-28,1187604,3431279,466414,741570,1529315,3554326,485436,11395944
2023-08-25,1172815,3436197,463443,737769,1524751,3473428,485511,11293914
2023-08-24,1193511,3421928,462474,734721,1521534,3429872,484553,11248593
2023-08-23,1182212,3421243,460853,730161,1517789,3372255,473093,11157606
2023-08-22,1216146,3442314,459804,728520,1514156,3263684,471376,11096000
2023-08-18,1176778,3456037,459498,729799,1509020,3204268,473767,11009167
2023-08-17,1196874,3439694,458081,729442,1505093,3171959,475572,10976715
2023-08-16,1242040,3428424,457217,728801,1500102,3127358,479042,10962984
2023-08-15,1305661,3429467,456920,726115,1495109,3090491,483721,10987484
2023-08-14,1306712,3430504,456375,724115,1491129,2991498,486981,10887314
2023-08-11,1298208,3420112,455171,721829,1484454,2937456,487052,10804282
2023-08-10,1303597,3357497,455145,718895,1478730,2909894,494065,10717823
2023-08-09,1238878,3295983,454857,715624,1476309,2900669,494596,10576916
2023-08-08,1230105,3249102,453841,713073,1469580,2944647,486798,10547146
2023-08-07,1228253,3230520,453121,710839,1464860,2904464,487472,10479529
2023-08-04,1242492,3211163,452005,710059,1459445,3116570,487888,10679622
2023-08-03,1233788,3168964,451373,707768,1472939,3200160,490314,10725306
2023-08-02,1224383,3141372,450466,702567,1456308,3253363,493347,10721806
2023-08-01,1212548,3131355,449073,700363,1453542,3316293,489175,10752349
2023-07-31,1174049,3151667,446888,695888,1459463,3298728,481961,10708644
2023-07-28,1139294,3139320,444920,693875,1452320,3282028,456559,10608316
2023-07-27,1180634,3114326,444768,691839,1450765,3245494,452983,10580809
2023-07-26,1193842,3108489,443177,688160,1447708,3184375,457598,10523349
2023-07-25,1216864,3095737,442939,686238,1444787,3143436,451146,10481147
2023-07-24,1206383,3094803,442665,684477,1441564,2986940,453974,10310806
2023-07-21,1178204,3093321,442756,684399,1436824,2975612,459974,10271090
2023-07-20,1206132,3068567,441653,681918,1433653,2931153,463776,10226852
2023-07-19,1183390,3051446,440829,681632,1430851,2888353,461279,10137780
2023-07-18,1176159,3038414,439295,680216,1427795,2847397,465601,10074877
2023-07-17,1233349,3039422,438991,678515,1424549,2764227,475474,10054527
2023-07-14,1182110,3035492,437662,677366,1420172,2732586,481347,9966735
2023-07-13,1223817,2996853,436386,674706,1416285,2705069,486972,9940088
2023-07-12,1228948,2980952,435416,672042,1412649,2703467,489584,9923058
2023-07-11,1204976,2963546,435272,669548,1408261,2752375,495260,9929238
2023-07-10,1205644,2964400,434362,668140,1405081,2688515,493574,9859716
2023-07-07,1159293,2933510,433231,665037,1403535,2791600,481416,9867622
2023-07-06,1123697,2904585,432398,662824,1402129,2794723,482522,9802878
2023-07-05,1130439,2875878,431740,662336,1403585,2909565,485797,9899340
2023-07-04,1147190,2855779,430542,663711,1403829,2993760,491862,9986673
2023-07-03,1184310,2860233,429885,660673,1402728,2958115,477852,9973796
2023-06-30,1125638,2914499,428609,657326,1414515,3050088,468784,10059459
2023-06-29,1143513,2880725,426234,655197,1414418,3071922,459715,10051724
2023-06-28,1130009,2849235,424546,651493,1414548,3053012,445573,9968416
2023-06-27,1128101,2825969,423895,647663,1413320,3019100,445330,9903378
2023-06-26,1121898,2818810,424208,640841,1410841,2933325,449045,9798968
2023-06-23,1095343,2812885,424000,635961,1408313,2875586,434805,9686893
2023-06-22,1069683,2792107,422264,632357,1406766,2815461,437548,9576186
2023-06-21,1114245,2809466,421612,629250,1404865,2686018,434799,9500255
2023-06-16,1091498,2811521,421196,629704,1401383,2671967,437712,9464981
2023-06-15,1094472,2795433,420028,627256,1398723,2635297,442372,9413581
2023-06-14,1040451,2771327,419569,625158,1396697,2614846,446990,9315038
2023-06-13,1049222,2749538,419595,621564,1393904,2658805,444487,9337115
2023-06-12,1029613,2745892,419740,618889,1391310,2601816,444639,9251899
2023-06-09,978157,2730266,419839,619067,1390123,2668353,448947,9254752
2023-06-08,954536,2703919,419279,617425,1386630,2793529,447201,9322519
2023-06-07,964190,2685592,418295,615835,1383523,2788501,445201,9301137
2023-06-06,986472,2667874,417262,612842,1381915,2812840,442268,9321473
2023-06-05,996308,2662691,416888,612602,1383535,2855610,439125,9366759
2023-06-02,988420,2660327,416766,613491,1383934,2955397,443097,9461432
2023-06-01,1048916,2650247,416153,611215,1382944,2938151,434321,9481947
2023-05-31,1012451,2661857,415087,607117,1389987,2880304,429831,9396634
2023-05-30,1040747,2658767,414465,603160,1386283,2893846,414546,9411814
2023-05-29,1050877,2677761,414034,601004,1386651,2794224,408991,9333542
2023-05-24,1023847,2673379,414450,600254,1383145,2748244,399226,9242545
2023-05-23,1020533,2653916,412411,598100,1380397,2708267,403843,9177467
2023-05-22,1021241,2661938,409610,596407,1382779,2651947,403023,9126945
2023-05-19,979963,2654500,409463,595647,1378299,2620179,404580,9042631
2023-05-18,1000326,2629672,408413,593518,1375449,2587967,408794,9004139
2023-05-17,994589,2612038,407264,591946,1372041,2564286,406336,8948500
2023-05-16,1015193,2595801,407190,591178,1368799,2537263,413120,8928544
2023-05-15,1020558,2592366,406552,589563,1365192,2467021,412337,8853589
2023-05-12,1021490,2582016,406392,589037,1359953,2423434,416726,8799048
2023-05-11,1064906,2558594,405376,585239,1356212,2382158,443585,8796070
2023-05-10,1067442,2534748,404746,583259,1352366,2357717,444446,8744724
2023-05-09,1054507,2522176,404740,581588,1350034,2398094,444430,8755569
2023-05-08,1048386,2514121,403791,580463,1346615,2365002,421422,8679800
2023-05-05,1042536,2505106,403903,573005,1342230,2507051,428091,8801922
2023-05-04,1041051,2469622,403270,570971,1342498,2557002,433000,8817414
2023-05-03,1064919,2464233,401790,566457,1340002,2568496,430894,8836791
2023-05-02,1091789,2491609,401628,554621,1341838,2590775,415830,8888090
2023-04-28,1048800,2491900,401748,559502,1338566,2603094,412150,8855760
2023-04-27,1040064,2445598,400193,559562,1337684,2602624,406613,8792338
2023-04-26,1066395,2397267,399154,555750,1334567,2550882,396983,8700998
2023-04-25,1022955,2361199,399297,553238,1330801,2517527,397516,8582533
2023-04-24,1037746,2348071,398645,552697,1321972,2438011,402889,8500031
2023-04-21,1008508,2335211,398675,551704,1316648,2376451,406592,8393789
2023-04-20,1023089,2300252,398006,548514,1312032,2339911,406172,8327976
2023-04-19,1021014,2254762,397392,547511,1306410,2295932,406487,8229508
2023-04-18,1013590,2233696,396895,546356,1302469,2269408,395925,8158339
2023-04-17,1031077,2234350,396724,543879,1297636,2212952,395857,8112475
2023-04-14,996931,2230811,396547,542618,1291975,2182706,395722,8037310
2023-04-13,1035913,2203992,396605,541071,1286586,2194115,395123,8053405
2023-04-12,1047255,2191063,396185,538336,1281742,2206400,395521,8056502
2023-04-11,1035874,2178538,396071,535662,1276119,2222970,392198,8037432
2023-04-10,1042125,2184987,396612,535055,1271255,2268004,391753,8089791
2023-04-05,1003782,2167051,396465,530908,1264515,2377034,374940,8114695
2023-04-04,968396,2141376,395887,532768,1261175,2442504,366108,8108214
2023-04-03,957205,2139756,395988,534463,1259946,2434065,376556,8097979
2023-03-31,887440,2151710,395452,529119,1260252,2433510,365312,8022795
2023-03-30,866099,2119487,394045,527993,1260666,2444390,354628,7967308
2023-03-29,870773,2093659,393319,522815,1258493,2410626,350821,7900506
2023-03-28,863022,2077876,393236,521592,1254442,2376314,351372,7837854
2023-03-27,889097,2108559,392510,520816,1250289,2292140,348240,7801651
2023-03-23,880161,2077494,392033,519452,1243246,2254079,343750,7710215
2023-03-22,877066,2060957,391494,515209,1238946,2219803,338448,7641923
2023-03-21,872576,2045518,390993,511527,1234346,2200526,339367,7594853
2023-03-20,876724,2038731,390610,510695,1230230,2142274,336955,7526219
2023-03-17,856659,2022142,390597,509559,1223127,2112147,337432,7451663
2023-03-16,869148,2000110,390141,508310,1219387,2098897,342367,7428360
2023-03-15,884178,1977823,389334,505435,1213967,2095219,339393,7405349
2023-03-14,884285,1959523,388610,504516,1209698,2137016,341630,7425278
2023-03-13,903748,1955322,388180,503922,1205585,2082884,334535,7374176
2023-03-10,896705,1950783,387854,502790,1200337,2152920,334523,7425912
2023-03-09,860455,1934122,387338,502406,1196099,2240456,340939,7461815
2023-03-08,858969,1920084,387179,501155,1191668,2258641,342019,7459715
2023-03-07,854615,1909415,386860,497939,1186981,2346530,342184,7524524
2023-03-06,891482,1906645,386844,496586,1183571,2321084,343309,7529521
2023-03-03,875185,1897246,386682,498390,1182072,2347528,343859,7530962
2023-03-02,876148,1875845,386418,497051,1180981,2361464,341628,7519535
2023-03-01,896748,1870353,386357,495530,1178418,2348540,339427,7515373
2023-02-28,863020,1880844,385586,492143,1177818,2312074,333029,7444514
2023-02-27,882130,1873159,385125,489648,1178738,2296073,327307,7432180
2023-02-24,885455,1861306,384564,489041,1175771,2242370,327136,7365643
2023-02-23,862619,1854159,384763,487603,1172668,2217988,327406,7307206
2023-02-22,881828,1864630,385098,487000,1171131,2140986,320182,7250855
2023-02-17,840031,1865206,384877,487675,1165780,2124105,320574,7188248
2023-02-16,852451,1852611,384532,486922,1161577,2095913,323875,7157881
2023-02-15,854343,1848652,384498,485366,1157450,2070008,319710,7120027
2023-02-14,849623,1836081,384082,483921,1153337,2054548,321513,7083105
2023-02-13,863140,1836690,384008,482368,1149220,2012088,320284,7047798
2023-02-10,838784,1837299,384242,481260,1144436,1992562,321225,6999808
2023-02-09,799398,1823876,384443,480810,1141504,1979997,323257,6933285
2023-02-08,790050,1807219,384334,479270,1136935,1980750,323261,6901819
2023-02-07,794151,1798408,384203,478371,1133671,2002778,324531,6916113
2023-02-06,819238,1798769,383846,477870,1129774,2073511,325252,7008260
2023-02-03,804509,1793159,382979,479538,1128083,2177190,327798,7093256
2023-02-02,802189,1783443,382339,469397,1127429,2220229,328333,7113359
2023-02-01,809924,1780312,382074,477301,1124999,2235114,325719,7135443
2023-01-31,771921,1786513,381256,474684,1123881,2261697,316965,7116917
2023-01-30,772596,1788239,381047,475113,1122756,2264170,312616,7116537
2023-01-27,758039,1787321,381394,473178,1119744,2241403,312846,7073925
2023-01-26,765478,1776884,380961,472196,1116730,2217487,314059,7043795
2023-01-25,766946,1770946,380110,471628,1113213,2189336,310720,7002899
2023-01-24,766429,1772127,379953,470867,1110208,2158809,312164,6970557
2023-01-23,767559,1778487,380068,469809,1107237,2114776,312695,6930631
2023-01-20,769743,1785718,380236,469405,1103224,2082848,315999,6907173
2023-01-19,770348,1780471,379647,467912,1100749,2062198,321452,6882777
2023-01-18,767987,1776939,379534,467519,1097413,2033415,322865,6845672
2023-01-17,762011,1773122,379380,466988,1093682,2010800,329557,6815540
2023-01-16,801119,1787899,379176,466446,1090163,1979034,328163,6832000
2023-01-13,786068,1790660,379331,467045,1085702,1957602,331578,6797986
2023-01-12,776169,1785724,378799,465834,1082370,1945819,335079,6769794
2023-01-11,790141,1777149,378389,465462,1079170,1947136,337909,6775356
2023-01-10,768488,1775253,378517,465157,1076725,1980333,337487,6781960
2023-01-09,751319,1774212,378340,465502,1073461,1949861,338382,6731077
2023-01-06,699918,1770692,378404,465616,1069077,2057546,343325,6784578
2023-01-05,727077,1766665,378089,466002,1066612,2087260,343400,6835105
2023-01-04,726552,1763514,378114,466841,1067025,2106702,343859,6852607
2023-01-03,737054,1760038,377889,466777,1066127,2171767,345269,6924921
2023-01-02,772206,1774178,377481,466296,1067963,2154326,346790,6959240
2022-12-30,708810,1789918,376315,465852,1064598,2154507,343481,6903481
2022-12-29,737947,1779741,376646,466945,1065816,2157555,336568,6921218
2022-12-28,742650,1763210,376020,466495,1065953,2135164,336983,6886475
2022-12-27,774168,1752446,375935,464115,1063669,2108604,337652,6876589
2022-12-26,798105,1743478,374766,463684,1061929,2051822,329141,6822925
2022-12-23,822543,1742970,374515,462834,1059256,1999742,328530,6790390
2022-12-22,841167,1733299,373669,460848,1056975,1977052,325156,6768166
2022-12-21,811634,1723078,373452,459792,1055807,1941566,326966,6692295
2022-12-20,820019,1716432,372261,459067,1054676,1917563,327693,6667711
2022-12-19,810288,1720978,371473,458552,1053294,1865221,330217,6610023
2022-12-16,808497,1717216,370924,458654,1050962,1862655,327740,6596648
2022-12-15,804223,1705318,370678,457135,1048650,1856519,326833,6569356
2022-12-14,773918,1689618,370606,456041,1047836,1880228,326724,6544971
2022-12-13,769985,1681357,369625,455449,1046642,1976909,327258,6627225
2022-12-12,770991,1695149,370047,454875,1044570,1932259,327754,6595645
2022-12-07,751794,1679110,369991,455356,1041092,1983320,328733,6609396
2022-12-06,752832,1659956,369018,455315,1038823,2029541,330624,6636109
2022-12-05,745984,1653239,368346,454831,1037928,2028574,335077,6623979
2022-12-02,747546,1649466,367841,455399,1036972,2078348,324410,6659982
2022-12-01,765539,1642453,367661,453743,1036965,2089944,323636,6679941
2022-11-30,737717,1659438,366649,451112,1037558,2033669,313158,6599301
2022-11-29,739121,1649849,366944,451446,1038174,2058912,299764,6604210
2022-11-28,780728,1647524,366661,448594,1037179,2011793,299773,6592252
2022-11-25,749034,1649919,366560,446966,1034644,1966755,297992,6511870
2022-11-24,740487,1640488,366190,444789,1031540,1945822,299619,6468935
2022-11-23,740695,1635095,366039,443431,1028822,1920663,299541,6434286
2022-11-22,757964,1644770,365815,442722,1026032,1876114,298646,6412063
2022-11-18,731626,1649140,365829,441568,1022617,1852696,300183,6363659
2022-11-17,730024,1637368,367068,440224,1019565,1831171,305850,6331270
2022-11-16,750105,1628635,366907,438990,1015352,1810638,304584,6315211
2022-11-15,751756,1625034,366610,437622,1012367,1791626,305434,6290449
2022-11-14,762479,1625669,366732,437451,1010461,1755294,311517,6269603
2022-11-11,760323,1629317,366736,436441,1006977,1738525,311218,6249537
2022-11-10,743863,1621881,366083,435201,1004077,1727470,310021,6208596
2022-11-09,728127,1610457,366008,434408,1001792,1719295,316285,6176372
2022-11-08,704422,1602409,365742,433264,998509,1757214,315312,6176872
2022-11-07,709458,1603226,365097,431770,994011,1778305,321311,6203178
2022-11-04,707403,1601155,365040,432501,992335,1847526,322298,6268258
2022-11-03,718764,1584353,367259,432105,992464,1819774,324284,6239003
2022-11-02,718749,1572712,367083,431427,992203,1880699,323464,6286337
2022-11-01,727933,1569138,367000,430611,990894,1898349,319539,6303464
2022-10-31,699005,1579629,366796,428607,990008,1878195,308774,6251014
2022-10-28,687737,1573319,366728,428109,990031,1881829,306134,6233887
2022-10-27,707341,1562595,366351,426426,990554,1867948,301556,6222771
2022-10-26,709984,1552956,365990,425263,988087,1837563,299197,6179040
2022-10-25,699513,1550741,365869,424499,986190,1819828,297464,6144104
2022-10-24,705526,1551701,366064,424391,984039,1773397,298972,6104090
2022-10-21,686121,1554849,365985,423928,981630,1741832,305265,6059610
2022-10-20,685570,1552552,365198,423216,979168,1724909,305182,6035795
2022-10-19,680771,1547253,365394,423033,976944,1697831,304547,5995773
2022-10-18,681853,1542536,365358,422257,974341,1679181,306363,5971889
2022-10-17,696172,1549314,365042,421928,971872,1632558,304837,5941723
2022-10-14,669113,1548545,365156,421805,969049,1622898,308584,5905150
2022-10-13,661955,1536162,364711,421046,966086,1622990,310782,5883732
2022-10-12,648181,1530294,364351,419896,962897,1674450,313510,5913579
2022-10-11,663205,1546802,363671,418415,959776,1669844,314382,5936095
2022-10-06,613866,1538250,363379,419064,956634,1721499,316793,5929485
2022-10-05,619692,1528442,363417,419282,955602,1742467,316739,5945641
2022-10-04,625311,1518717,363376,418331,955731,1810067,316477,6008010
2022-10-03,644228,1526377,363490,419431,954185,1792155,314487,6014353
2022-09-30,582980,1540983,363354,418283,954771,1798360,307348,5966079
2022-09-29,596848,1531209,362963,417303,955139,1801843,304268,5969573
2022-09-28,598942,1523351,362649,415682,954003,1780123,305217,5939967
2022-09-27,622212,1512827,362235,413464,952091,1760607,298224,5921660
2022-09-26,646262,1518445,361563,412583,949229,1721724,294416,5904222
2022-09-23,627792,1523795,361216,412596,947359,1692449,296182,5861389
2022-09-22,619770,1516193,360890,411771,944852,1676121,299703,5829300
2022-09-21,626391,1513699,361803,411303,942484,1656496,300541,5812717
2022-09-20,633315,1515014,361263,410586,940332,1643764,303342,5807616
2022-09-19,630023,1519117,361194,410039,937839,1610602,301625,5770439
2022-09-16,629783,1523480,361074,409717,934289,1592553,300150,5751046
2022-09-15,642441,1518190,360060,407746,930755,1582147,301000,5742339
2022-09-14,625748,1505605,360035,407381,928192,1574312,302875,5704148
2022-09-13,625085,1501020,359792,406770,925210,1604874,300882,5723633
2022-09-12,623332,1506771,359952,406708,922476,1590171,301667,5711077
2022-09-09,617490,1508027,360262,406559,920298,1664540,303273,5780449
2022-09-08,603543,1496186,360025,405017,919922,1689420,302378,5776491
2022-09-07,601320,1489071,360035,404241,917727,1716887,303578,5792859
2022-09-06,629819,1480832,359702,401445,915864,1763291,305612,5856565
2022-09-05,658500,1487547,359245,399404,916111,1766624,304539,5891970
2022-09-01,640803,1483681,358433,400271,915777,1755572,300311,5854848
2022-08-31,591322,1506582,357629,397450,915286,1724124,298577,5790970
2022-08-30,600234,1502843,356332,396611,915933,1755233,292636,5819822
2022-08-29,606871,1504853,355177,393758,915904,1702260,289468,5768291
2022-08-26,612083,1505377,354351,393122,914345,1687565,291517,5758360
2022-08-25,618744,1500889,352272,391187,912530,1671289,288914,5735825
2022-08-24,626991,1495498,352096,389874,910860,1650016,292919,5718254
2022-08-23,634111,1493446,351845,388846,909219,1641600,293276,5712343
2022-08-22,650227,1502846,351496,387001,910227,1609130,292335,5703262
2022-08-19,638768,1506580,351197,387163,908188,1589552,295040,5676488
2022-08-18,634406,1501176,350544,385409,906236,1571641,299024,5648436
2022-08-17,647061,1499635,350347,384228,906989,1554936,298435,5641631
2022-08-16,673262,1513611,349757,382281,901898,1519766,296397,5636972
2022-08-12,652032,1514178,349217,382201,898443,1503332,302068,5601471
2022-08-11,658357,1502610,348698,380552,895328,1493498,296943,5575986
2022-08-10,653488,1494423,347931,378627,892520,1484908,293480,5545377
2022-08-09,652111,1487763,348122,377898,890714,1515077,292470,5564155
2022-08-08,663084,1487896,347949,378652,888159,1533909,295558,5595207
2022-08-05,653577,1487269,347884,378342,885306,1575680,289795,5617853
2022-08-04,658751,1476722,347753,377863,883563,1594403,294251,5633306
2022-08-03,655806,1470432,346496,376003,885350,1581992,292818,5608897
2022-08-02,644431,1464926,346358,375125,885348,1654079,292729,5662996
2022-08-01,669645,1477160,345671,374516,882652,1647881,288578,5686103
2022-07-29,628558,1484662,344907,374302,879610,1650578,285522,5648139
2022-07-28,635404,1459768,344991,370861,880721,1648516,287379,5627640
2022-07-27,623960,1447644,344196,368924,879825,1627018,286835,5578402
2022-07-26,630979,1424978,343721,366675,878075,1612885,286625,5543938
2022-07-25,646528,1425201,343243,366602,875924,1571095,285282,5513875
2022-07-22,620532,1421976,343157,365900,873740,1541877,286572,5453754
2022-07-21,628326,1411970,343247,364143,871680,1529383,291089,5439838
2022-07-20,622463,1404919,342886,362400,869642,1510378,292230,5404918
2022-07-19,622366,1396864,342731,360362,867028,1495532,298150,5383033
2022-07-18,640163,1400950,342625,360148,865268,1461520,298072,5368746
2022-07-15,625061,1401895,342509,358847,862913,1445782,301427,5338434
2022-07-14,607736,1391757,340898,357642,860853,1431743,301519,5292148
2022-07-13,617295,1385168,340727,356459,858749,1436806,302397,5297601
2022-07-12,603744,1378408,340500,354778,856451,1461823,302313,5298017
2022-07-11,596154,1381658,340747,354030,854497,1443360,301094,5271540
2022-07-08,574669,1375213,340755,353429,853250,1508794,302342,5308452
2022-07-07,574365,1364095,340147,352242,851303,1524977,302409,5309538
2022-07-06,583541,1355467,339878,350005,849558,1538529,299388,5316366
2022-07-05,580597,1343644,339533,348764,850098,1605326,298751,5366713
2022-07-04,595011,1335364,339143,348079,847882,1592174,300480,5358133
2022-07-01,590344,1336468,339012,346692,847748,1609506,296115,5365885
2022-06-30,563023,1358749,337974,344653,846130,1607529,296487,5354545
2022-06-29,549005,1349955,336246,344987,848430,1607045,296407,5332075
2022-06-28,565318,1333609,335099,342817,848144,1596827,297877,5319691
2022-06-27,590393,1331765,334031,342055,847005,1565286,297085,5307620
2022-06-24,583366,1325323,333841,338843,845279,1542102,295877,5264631
2022-06-23,590685,1311115,332365,336311,843622,1526331,296777,5237206
2022-06-22,600326,1303900,331966,334911,841972,1509186,296713,5218974
2022-06-21,601604,1316432,331899,334419,840933,1461995,294218,5181500
2022-06-16,565154,1313943,332148,334279,838198,1440433,298538,5122693
2022-06-15,574073,1296785,330524,332547,836104,1425723,298268,5094024
2022-06-14,561748,1284780,330261,331859,833837,1413170,300017,5055672
2022-06-13,563582,1282535,328699,329838,831750,1391379,298331,5026114
2022-06-10,550483,1281335,328149,328363,829557,1372654,297518,4988059
2022-06-09,536555,1271841,327468,327841,828049,1365992,297561,4955307
2022-06-08,523363,1262204,327266,326376,825686,1371030,292848,4928773
2022-06-07,528070,1257172,326516,325273,824168,1396472,289245,4946916
2022-06-06,547229,1256176,325971,324712,822850,1387135,289869,4953942
2022-06-03,535341,1251272,325342,324871,822596,1426686,290092,4976200
2022-06-02,538714,1241301,322824,323361,822189,1474119,290931,5013439
2022-06-01,556344,1240625,322792,325562,821296,1469877,286485,5022981
2022-05-31,536080,1251524,320137,323533,819626,1482656,283997,5017553
2022-05-30,528383,1255489,320721,318365,821356,1476072,278679,4999065
2022-05-27,528430,1251693,320579,317008,820330,1459233,273489,4970762
2022-05-26,529122,1250628,319961,315557,818287,1435193,272445,4941193
2022-05-24,507535,1245398,320183,314487,816956,1414428,267952,4886939
2022-05-23,528240,1241122,319289,313011,814787,1383396,268181,4868026
2022-05-20,514966,1243820,319221,312553,812667,1361759,269089,4834075
2022-05-19,510477,1240456,319081,310880,810961,1342513,272526,4806894
2022-05-17,499107,1237590,318686,310505,808909,1327998,272279,4775074
2022-05-16,515827,1240508,318629,308700,807106,1303589,268712,4763071
2022-05-13,488491,1241295,318454,306703,805053,1296801,269890,4726687
2022-05-12,486258,1231489,318129,305755,802629,1286670,272041,4702971
2022-05-11,488915,1224898,317401,304636,800513,1281474,271677,4689514
2022-05-10,478538,1220194,317336,303453,798642,1300651,272664,4691478
2022-05-09,492838,1217069,317186,303181,797550,1287510,274222,4689556
2022-05-06,464341,1216955,317071,301665,795403,1333950,274248,4703633
2022-05-05,467765,1210336,316488,301467,794021,1337880,274322,4702279
2022-05-04,464848,1201058,316055,301122,794152,1358293,274855,4710383
2022-05-03,482358,1194571,315767,300192,792410,1414897,275832,4776027
2022-05-02,519902,1204913,315495,299640,793498,1399339,269875,4802662
2022-04-29,482131,1206157,314912,298198,790939,1395903,268292,4756532
2022-04-28,484066,1193717,314282,296276,793307,1404993,266112,4752753
2022-04-27,478281,1191411,314281,293832,793213,1387048,263959,4722025
2022-04-26,478401,1184761,313759,293011,791904,1374541,261271,4697648
2022-04-25,502316,1186974,313670,292391,790168,1345378,259485,4690382
2022-04-22,488259,1190086,313805,292067,788207,1323366,259728,4655518
2022-04-21,474613,1185136,313653,290852,786212,1309028,258631,4618125
2022-04-20,468643,1180745,312289,289951,783945,1294845,257883,4588301
2022-04-19,461184,1177562,311934,288964,781619,1286341,260724,4568328
2022-04-18,495376,1184325,311348,287938,779187,1254172,258992,4571338
2022-04-13,447863,1180380,311295,287514,775644,1251518,261088,4515302
2022-04-12,444243,1174430,310585,286090,772493,1267809,262968,4518618
2022-04-11,446405,1168475,310340,284348,770251,1245178,259865,4484862
2022-04-08,421329,1164872,310302,284256,768014,1297521,259724,4506018
2022-04-07,424508,1156556,309878,283247,765609,1309312,260054,4509164
2022-04-06,429455,1151301,309308,282195,763680,1314670,260380,4510989
2022-04-05,432683,1147245,308787,280641,763359,1339379,260237,4532331
2022-04-04,450050,1146039,308887,280808,761909,1343624,260587,4551904
2022-04-01,435531,1150985,308860,282297,762056,1349490,259086,4548305
2022-03-31,428798,1154526,308493,278380,759972,1341559,258322,4530050
2022-03-30,423952,1145950,306286,278011,760918,1343440,252006,4510563
2022-03-29,433795,1135978,305710,274549,760141,1333425,248589,4492187
2022-03-28,454379,1123124,305197,273297,758109,1303915,236714,4454735
2022-03-25,443562,1121883,305143,273013,755732,1276924,234378,4410635
2022-03-23,444936,1103998,304292,271586,755062,1263021,234068,4376963
2022-03-22,452237,1100872,303746,270076,752181,1251938,232635,4363685
2022-03-21,457005,1104150,303211,268937,750871,1226532,233833,4344539
2022-03-18,453098,1102534,302742,267781,748271,1212869,235920,4323215
2022-03-17,447583,1097282,302205,267453,746353,1206379,235951,4303206
2022-03-16,450545,1090964,301957,266692,744073,1212227,235976,4302434
2022-03-15,452971,1093286,301622,265605,741474,1212960,236371,4304289
2022-03-14,448495,1095380,301572,265246,739431,1205622,237428,4293174
2022-03-11,440226,1095581,301481,264807,736485,1272033,238369,4348982
2022-03-10,425630,1091008,301264,263322,733984,1273110,239612,4327930
2022-03-09,423139,1084230,301175,263269,732406,1279598,239269,4323086
2022-03-08,430369,1076015,300801,262607,730197,1313803,238190,4351982
2022-03-07,447445,1073470,300173,262113,728324,1305483,237436,4354444
2022-03-04,442481,1069876,299803,262872,728096,1312700,238826,4354654
2022-03-03,458069,1065734,299046,261921,726489,1327868,237925,4377052
2022-03-02,472417,1079240,298939,261273,727486,1305285,237113,4381753
2022-02-25,432553,1086211,298576,261238,725030,1276510,239981,4320099
2022-02-24,429780,1075412,297085,262560,726393,1271336,235825,4298391
2022-02-23,424092,1068053,296659,260594,725319,1259071,234127,4267915
2022-02-22,419418,1063720,296006,259759,723408,1249021,232028,4243360
2022-02-21,423984,1065143,295877,258974,721632,1227197,229361,4222168
2022-02-18,411967,1065483,294891,256391,719813,1216698,230862,4196105
2022-02-17,417352,1058051,294394,255507,717744,1204658,231125,4178831
2022-02-16,420402,1053368,294123,254915,715977,1193474,230338,4162597
2022-02-15,418268,1050977,293733,254668,713877,1185277,230797,4147597
2022-02-14,415679,1053288,293677,254399,712082,1169222,232896,4131243
2022-02-11,412677,1056760,293688,253039,709759,1161215,230521,4117659
2022-02-10,402236,1055349,293620,252328,707975,1154676,231624,4097808
2022-02-09,392390,1048931,293165,252078,706149,1149980,231375,4074068
2022-02-08,387356,1043626,293149,251506,703774,1174289,231487,4085187
2022-02-07,400070,1046178,293080,251329,701989,1189607,231508,4113761
2022-02-04,393579,1045781,293217,251305,700954,1231585,231361,4147782
2022-02-03,397971,1038987,292957,250562,701300,1221742,230397,4133916
2022-02-02,405394,1034344,292540,250189,700824,1258101,231789,4173181
2022-02-01,410008,1036693,292492,249827,699974,1275473,228892,4193359
2022-01-31,408521,1054034,292399,251433,696086,1273507,227094,4203074
2022-01-28,397978,1050544,291983,248029,696869,1275479,226863,4187745
2022-01-27,405068,1045926,291809,246456,696181,1266905,226037,4178382
2022-01-26,404973,1041764,291004,245679,695212,1251752,227484,4157868
2022-01-25,408138,1041249,290542,244442,693771,1241924,227837,4147903
2022-01-24,418665,1042475,290365,243145,692352,1217896,227339,4132237
2022-01-21,408262,1046063,290272,243221,690586,1204400,227096,4109900
2022-01-20,404701,1046449,289875,242347,689665,1192249,229428,4094714
2022-01-19,405225,1046960,289834,241725,688261,1181235,232469,4085709
2022-01-18,407165,1046178,289456,241047,686619,1170131,231780,4072376
2022-01-17,418182,1053882,289481,240740,685334,1156623,233174,4077416
2022-01-14,403015,1056265,289230,240643,684324,1149306,235554,4058337
2022-01-13,399965,1051828,288976,239915,682727,1145123,238603,4047137
2022-01-12,405032,1048820,288531,239389,681264,1146870,237128,4047034
2022-01-11,397104,1048857,288328,238263,679732,1167340,236484,4056108
2022-01-10,397891,1052575,288577,237679,678384,1161674,237144,4053924
2022-01-07,369680,1053770,288792,237836,678201,1210583,238893,4077755
2022-01-06,369275,1044934,288201,236981,677201,1222159,238381,4077132
2022-01-05,381713,1041255,288005,236834,677226,1229504,239609,4094146
2022-01-04,384541,1044381,288102,236664,676679,1255107,238788,4124262
2022-01-03,407403,1058651,282954,236659,676245,1247015,241064,4149991
2021-12-30,382814,1061688,287672,236083,674962,1263085,235155,4141459
2021-12-29,382855,1055085,287132,235328,676992,1257483,233842,4128717
2021-12-28,390965,1043750,288766,234506,675433,1248025,235143,4116588
2021-12-27,409129,1045495,285812,233914,674009,1210563,232963,4091885
2021-12-23,405490,1041143,285290,233828,673419,1193893,230343,4063406
2021-12-22,403704,1030801,281759,232076,672999,1181776,224374,4027489
2021-12-21,400276,1023083,282585,231388,671517,1171168,224397,4004414
2021-12-20,418791,1022210,281367,230662,670225,1146626,224351,3994232
2021-12-17,399781,1018883,281269,229861,668899,1139796,225498,3963987
2021-12-16,399692,1009423,280165,228571,667541,1134105,225766,3945263
2021-12-15,395707,1004884,279629,227556,665869,1129873,224302,3927820
2021-12-14,388233,997244,279124,226916,664182,1153042,223064,3931805
2021-12-13,396373,995867,278276,226135,662491,1146048,223672,3928862
2021-12-10,389385,993386,276752,225149,660681,1197750,223750,3966853
2021-12-09,385957,986911,276080,224886,659641,1201497,224610,3959582
2021-12-07,382548,980618,275704,224524,657420,1233921,223847,3978582
2021-12-06,384343,978301,274887,224917,655987,1225949,224162,3968546
2021-12-03,377034,971555,274744,225600,655907,1231754,224377,3960971
2021-12-02,379482,964819,273874,225745,655910,1231977,225264,3957071
2021-12-01,383332,963730,273125,225313,654739,1229908,225197,3955344
2021-11-30,383740,967209,273116,222277,651163,1219534,224376,3941415
2021-11-29,393636,962923,272513,221322,651994,1206803,220842,3930033
2021-11-26,386583,960292,271954,220532,650669,1186420,219242,3895692
2021-11-25,381525,957133,271327,219344,649152,1180723,219516,3878720
2021-11-24,370192,955516,270996,217997,647544,1169020,219259,3850524
2021-11-23,380193,960156,270871,217320,645663,1149859,218903,3842965
2021-11-19,369300,963630,270838,216639,643619,1134564,217796,3816386
2021-11-18,375606,955298,269807,215366,641707,1123855,216845,3798484
2021-11-17,376768,949977,269283,214365,640027,1111911,216473,3778804
2021-11-16,376041,947519,268848,213482,637972,1103179,215748,3762789
2021-11-15,378221,947919,268673,213646,635870,1083744,215087,3743160
2021-11-12,372088,947563,268624,211734,633846,1072801,215004,3721660
2021-11-11,373803,934511,267327,210328,631447,1068849,213964,3700229
2021-11-10,364674,924506,266788,209503,629046,1062384,213390,3670291
2021-11-09,350955,915991,265876,209336,627209,1077627,212576,3659570
2021-11-08,351593,909177,265556,207984,625412,1085422,211531,3656675
2021-11-05,342323,900720,265267,207865,622874,1113381,211752,3664182
2021-11-04,350281,893406,265022,207678,621386,1100347,207441,3645561
2021-11-03,349737,882066,264899,206950,620885,1103642,206554,3634733
2021-11-02,350668,877884,264584,206173,621068,1132581,206265,3659223
2021-11-01,360934,881409,264455,206959,619461,1115942,205441,3654601
2021-10-29,349209,884533,263869,203737,617294,1130725,200883,3650250
2021-10-28,353065,868885,263603,202583,615406,1123477,203107,3630126
2021-10-27,352841,861159,263608,201650,614228,1107914,200225,3601625
2021-10-26,350533,854495,262768,200477,612371,1096768,200761,3578173
2021-10-25,360426,854312,267783,199791,610476,1087329,200623,3580740
2021-10-22,349893,849250,261527,199196,608356,1059957,197562,3525741
2021-10-21,352508,843538,260968,197814,606406,1049286,196602,3507122
2021-10-20,357025,840188,260712,197100,604476,1038934,196006,3494441
2021-10-19,358467,831419,260165,196569,602287,1028808,198491,3476206
2021-10-18,370764,829233,259649,195831,600161,1002345,199755,3457738
2021-10-15,358035,830040,259349,195249,598132,993627,199137,3433569
2021-10-14,356956,822716,259124,194081,595873,988318,203578,3420646
2021-10-13,350870,818227,258816,193284,593565,1024728,203871,3443361
2021-10-12,358880,825603,258373,194037,591495,1025747,204088,3458223
2021-10-07,326979,820978,258303,193935,590071,1060485,204360,3455111
2021-10-06,327866,814712,257854,193127,588198,1062382,203544,3447683
2021-10-05,327891,809816,257610,192489,587702,1091820,203366,3470694
2021-10-04,333733,809140,257844,192514,586949,1085677,205629,3471486
2021-10-01,331532,811583,257766,190546,587191,1097825,204903,3481346
2021-09-30,318443,817111,257253,190461,584175,1089035,202721,3459199
2021-09-29,320959,807532,255722,188971,583350,1088508,205177,3450219
2021-09-28,321502,802132,254622,187700,582910,1081998,200908,3431772
2021-09-27,322926,800711,253870,186848,581667,1064501,200673,3411196
2021-09-24,320656,799694,253220,186138,580433,1052747,203106,3395994
2021-09-23,320009,797617,252226,184957,579347,1044809,203990,3382955
2021-09-22,322618,793200,251644,184063,577582,1034667,199322,3363096
2021-09-21,326653,789971,251170,183371,576180,1024486,197338,3349169
2021-09-20,329848,789957,250766,182772,574669,998618,197328,3323958
2021-09-17,321032,788228,250281,182299,573244,981370,198724,3295178
2021-09-16,323653,782479,250058,181481,571615,971996,200753,3282035
2021-09-15,315103,778598,249921,180607,569721,962616,205333,3261899
2021-09-14,315299,776525,249373,179708,568057,952213,206589,3247764
2021-09-13,319960,777335,249094,179090,566397,938620,206732,3237228
2021-09-10,313921,780049,249146,178042,564915,931718,207779,3225570
2021-09-09,303277,772458,249242,177499,563387,933129,207747,3206739
2021-09-08,306864,766028,248831,176638,561784,938512,208392,3207049
2021-09-07,304741,761188,248478,176118,560251,967775,208387,3226938
2021-09-06,316443,759153,248460,176085,559188,965771,208652,3233752
2021-09-03,309911,756300,248560,176202,559556,993721,208993,3253243
2021-09-02,313124,750081,247863,175347,559853,1020860,209591,3276719
2021-09-01,316768,748318,247800,175644,559843,1024314,206888,3279575
2021-08-31,300439,752115,247944,175631,556609,1035548,204507,3272793
2021-08-30,304091,751706,247268,172342,557456,1029327,204051,3266241
2021-08-27,314555,750069,247249,171276,557100,1022405,199233,3261887
2021-08-26,323159,744885,246513,170472,555751,1012106,199107,3251993
2021-08-25,322760,742291,246339,169860,554597,1000984,199502,3236333
2021-08-24,319743,739466,246099,168912,553302,994658,198541,3220721
2021-08-23,317541,739388,245958,168216,551917,974584,196860,3194464
2021-08-20,319147,736902,245716,167664,550667,961249,197797,3179142
2021-08-19,321910,729946,245526,167120,549359,954609,198293,3166763
2021-08-18,327839,728401,245310,166244,547714,940413,196208,3152129
2021-08-17,339069,724823,245239,165723,546132,925451,197134,3143571
2021-08-13,325872,725177,244933,165323,544776,919334,199896,3125311
2021-08-12,332652,721905,244115,164239,543039,914093,201499,3121542
2021-08-11,341362,718230,243923,163662,541498,916338,199859,3124872
2021-08-10,336258,715694,243915,163059,540210,940735,201580,3141451
2021-08-09,325458,714117,243798,163051,539425,935600,201662,3123111
2021-08-06,314127,714140,243665,162817,538673,964613,202346,3140381
2021-08-05,323109,709965,242887,161765,537668,958890,202322,3136606
2021-08-04,320985,704859,242631,161688,538071,966481,203133,3137848
2021-08-03,324447,701688,242350,161230,537641,1002510,203813,3173679
2021-08-02,327739,708826,241907,161025,538578,990268,203165,3171508
2021-07-30,312401,709933,242125,160955,535442,994909,201486,3157251
2021-07-29,316619,703960,241561,160577,536132,994105,205388,3158342
2021-07-28,326747,698223,241482,158531,535656,984759,198856,3144254
2021-07-27,327317,696190,241127,157794,535195,978347,198946,3134916
2021-07-26,330142,696912,240995,157459,534332,959920,198500,3118260
2021-07-23,329196,695589,240854,156938,533535,949746,198368,3104226
2021-07-22,333476,692461,240824,155868,532175,938569,196038,3089411
2021-07-21,325426,689310,240701,155308,531768,931712,197006,3071231
2021-07-20,326253,688264,240398,154745,530729,928811,195387,3064587
2021-07-19,324855,692677,240103,154230,529397,914310,196135,3051707
2021-07-16,321925,688533,240078,153890,528623,906492,196129,3035670
2021-07-15,321490,685524,239781,153325,527525,902848,196483,3026976
2021-07-14,317711,682807,239553,152801,527396,908096,197087,3025451
2021-07-13,312694,680283,239559,152155,526524,928795,197332,3037342
2021-07-12,314500,684575,239528,151799,525829,929356,197456,3043043
2021-07-08,302124,681992,239433,151812,526067,961555,197987,3060970
2021-07-07,296377,677033,238679,151198,525595,968137,198368,3055387
2021-07-06,305138,673153,238505,151201,523981,996684,197719,3086381
2021-07-05,298486,676089,238426,150863,524681,990711,198828,3078084
2021-07-02,298573,674720,238353,150844,525914,1008139,199447,3095990
2021-07-01,299645,675906,238205,149842,525747,1006430,199952,3095727
2021-06-30,277633,699455,238398,149580,524531,997852,198998,3086447
2021-06-29,283592,687590,237577,148229,525428,1019431,196169,3098016
2021-06-28,283922,685355,237065,147672,525070,1000265,195231,3074580
2021-06-25,285209,683011,236425,147058,524583,989288,195689,3061263
2021-06-24,287038,677476,236158,145976,524233,982757,196341,3049979
2021-06-23,285981,675177,235683,145376,523728,974047,194324,3034316
2021-06-22,291552,677647,235484,144492,522963,956834,194173,3023145
2021-06-18,274676,675363,235555,144054,522340,945146,194297,2991431
2021-06-17,272973,671223,235291,143270,521661,937539,193618,2975575
2021-06-16,276794,668612,235235,142721,521123,929077,194134,2967696
2021-06-15,276542,667306,235128,141985,520019,919522,197129,2957631
2021-06-14,271521,667412,234916,141746,519180,914046,195935,2944756
2021-06-11,271274,668015,234770,141243,518693,907494,197773,2939262
2021-06-10,265526,664979,234852,140453,518239,904778,198058,2926885
2021-06-09,259421,660077,234703,140372,518690,911185,198519,2922967
2021-06-08,262671,658740,234692,139814,517927,937757,199301,2950902
2021-06-07,266236,659784,234627,139809,517327,931997,199630,2949410
2021-06-04,264940,658138,234527,139870,516657,958346,199565,2972043
2021-06-03,260212,654406,233206,138873,517445,966063,199965,2970170
2021-06-02,257389,649721,233188,139492,518531,983884,200833,2983038
2021-06-01,264168,653619,233268,138874,517456,993923,198890,3000198
2021-05-31,251420,658230,233041,137287,515601,979444,196262,2971285
2021-05-28,266786,657508,232862,136924,517008,996093,196058,3003239
2021-05-27,278340,655834,232700,136234,517080,978755,194671,2993614
2021-05-26,279851,658822,232617,135872,515865,965795,194727,2983549
2021-05-21,251843,658869,232713,135658,514860,954759,195157,2943859
2021-05-20,258682,653100,232321,135217,514129,947681,192590,2933720
2021-05-19,261870,652064,232043,134562,513418,941264,190389,2925610
2021-05-18,268159,650075,231762,134103,513168,937876,190973,2926116
2021-05-17,270072,653679,231578,133765,512261,922243,190421,2914019
2021-05-14,262858,659481,231560,133499,511219,913563,191556,2903736
2021-05-13,262528,657995,231186,133054,510539,904741,191883,2891926
2021-05-12,267934,657131,231040,132641,509348,902362,192113,2892569
2021-05-11,270136,656233,231100,132340,508140,919760,192217,2909926
2021-05-10,270109,658910,231432,131705,507285,902785,191986,2894212
2021-05-07,261607,656828,231043,131882,506796,932721,193003,2913880
2021-05-06,255896,654082,230755,131758,506072,922642,191319,2892524
2021-05-05,251256,651871,230680,131585,506544,931243,191026,2894205
2021-05-04,258155,648587,230653,131562,506188,972599,191723,2939467
2021-05-03,257137,651694,230646,132230,505748,966801,190334,2934590
2021-04-30,241715,657354,230586,131503,504177,956171,187921,2909427
2021-04-29,250188,653884,229850,130620,505611,975297,187785,2933235
2021-04-28,252396,648628,229498,129789,505462,969562,186712,2922047
2021-04-27,258424,647997,229023,129147,504872,965591,187141,2922195
2021-04-26,260044,649559,228947,128784,503846,947331,185367,2903878
2021-04-23,261347,649260,228958,128292,502801,939692,185194,2895544
2021-04-22,263332,645891,228776,127845,504346,933657,179199,2883046
2021-04-21,267546,642880,228610,127503,503524,928450,180229,2878742
2021-04-20,267979,644582,228587,127059,502359,925767,180450,2876783
2021-04-19,268577,648279,228411,126703,501500,912097,180100,2865667
2021-04-16,273067,651308,228427,125972,500157,902403,180663,2861997
2021-04-15,269040,650839,228156,125678,498872,899908,180640,2853133
2021-04-14,267400,649549,228086,125330,497755,900206,180851,2849177
2021-04-13,268838,649303,227807,125121,496356,912794,182234,2862453
2021-04-12,266628,655429,227820,124829,495435,914549,182872,2867562
2021-04-09,261421,656139,227814,124875,494657,931705,183500,2880111
2021-04-08,257186,652234,227559,124628,493491,939415,184658,2879171
2021-04-07,258860,650050,227521,124368,492644,946370,183951,2883764
2021-04-06,269504,649734,227452,124465,491132,965584,184184,2912055
2021-04-05,278655,653925,227581,124285,491031,958350,182106,2915933
2021-03-31,250486,658512,228119,124921,488078,946388,183323,2879827
2021-03-30,260408,657637,226556,123497,490017,960489,181777,2900381
2021-03-29,265106,658350,226239,122498,489259,945599,181161,2888212
2021-03-26,267032,658443,225731,121877,488378,932252,179791,2873504
2021-03-25,270009,656711,225088,121448,487221,922982,177349,2860808
2021-03-23,273381,656167,224850,121164,485951,918308,176636,2856457
2021-03-22,279897,654835,224583,120651,484885,904724,175355,2844930
2021-03-19,274093,660456,224000,119959,483391,894624,177039,2833562
2021-03-18,279504,655835,223974,119400,482298,889672,177218,2827901
2021-03-17,287243,654457,223747,118902,481181,890996,175926,2832452
2021-03-16,290701,655338,223122,118479,479910,911508,176127,2855185
2021-03-15,296328,656808,223041,118282,478412,906256,176417,2855544
2021-03-12,288892,658329,223015,118154,477533,924801,177289,2868013
2021-03-11,289702,656694,222396,117792,476179,924009,179146,2865918
2021-03-10,289202,655282,222109,117590,475297,911029,179338,2849847
2021-03-09,288981,651926,222218,117394,474653,929634,179510,2864316
2021-03-08,287819,649203,221718,117922,473607,923608,180455,2854332
2021-03-05,285501,651472,221659,117630,472656,933447,182009,2864374
2021-03-04,296076,648342,221102,117624,472068,929959,182594,2867765
2021-03-03,292797,645828,221015,117291,472297,944581,183136,2876945
2021-03-02,302823,646394,220840,116792,472618,953200,183833,2896500
2021-03-01,310919,649645,220888,116783,471813,936767,182501,2889316
2021-02-26,304028,652627,221395,116178,467959,913464,181502,2857153
2021-02-25,308210,649003,220483,115839,470672,922998,180569,2867774
2021-02-24,308060,647838,220530,114307,469807,917527,179073,2857142
2021-02-23,307447,646823,220300,114146,468973,914273,179815,2851777
2021-02-22,306688,648051,220227,113911,468291,892766,179191,2829125
2021-02-19,310541,648195,220295,114698,467108,883679,177644,2822160
2021-02-18,310842,645731,219953,113515,466059,887054,176297,2819451
2021-02-17,318746,650838,219162,111822,465029,870557,176779,2812933
2021-02-12,304067,652471,219219,111936,463451,862791,177187,2791122
2021-02-11,303444,649692,218929,112449,462487,860370,178543,2785914
2021-02-10,302219,648712,219168,112310,461600,861846,178985,2784840
2021-02-09,303720,645430,219598,112508,460721,881594,180317,2803888
2021-02-08,302224,646569,219430,112419,459625,880294,180591,2801152
2021-02-05,301767,647852,219336,112748,458877,901628,181330,2823538
2021-02-04,302096,645621,218861,112619,458284,901225,183385,2822091
2021-02-03,299608,643732,218769,112259,458401,908421,182150,2823340
2021-02-02,307529,643207,218769,111831,457617,932696,180482,2852131
2021-02-01,305696,649257,218653,112633,457135,929949,181080,2854403
2021-01-29,297087,651704,218938,112401,453937,911082,179069,2824218
2021-01-28,301719,648187,218249,110892,457843,928216,180571,2845677
2021-01-27,303122,647861,218188,109844,457659,921689,176388,2834751
2021-01-26,304840,647002,218097,109536,457393,913896,176315,2827079
2021-01-25,308703,647490,217862,109372,456596,899610,177862,2817495
2021-01-22,306491,645752,217801,108882,455514,889176,176248,2799864
2021-01-21,308119,642445,217581,108787,452747,882510,173221,2785410
2021-01-20,304809,642138,217580,108360,452054,875998,171705,2772644
2021-01-19,305861,644979,217342,108335,451480,871958,171479,2771434
2021-01-18,309559,646385,217297,107979,450402,860861,171832,2764315
2021-01-15,298168,649574,217124,107633,449227,851404,172617,2745747
2021-01-14,296633,646857,216328,107507,448540,847468,174049,2737382
2021-01-13,299447,645518,216319,108096,447869,851101,173861,2742211
2021-01-12,302420,643962,216227,107695,447210,869917,174243,2761674
2021-01-11,308649,646056,216223,107456,446538,860562,175409,2760893
2021-01-08,281427,644851,216295,107596,446333,890648,176096,2763246
2021-01-07,277942,642827,216210,107494,445900,898120,175924,2764417
2021-01-06,273197,641980,216267,107094,446298,900598,174759,2760193
2021-01-05,278004,644149,216087,107061,446674,917350,175042,2784367
2021-01-04,281909,650194,216134,107927,446492,917792,175797,2796245
2020-12-30,260577,656213,215744,107830,443879,918756,174511,2777510
2020-12-29,267500,654249,215492,104719,448285,904468,176021,2770734
2020-12-28,282047,654187,215267,104150,448203,883243,176029,2763126
2020-12-23,274199,653397,215225,103856,447888,868666,176944,2740175
2020-12-22,277169,651826,214811,102947,447417,858964,177444,2730578
2020-12-21,284949,649086,214886,102753,444966,848145,179281,2724066
2020-12-18,281582,646971,214809,102329,444159,839740,177732,2707322
2020-12-17,283839,644341,214561,102089,443328,834331,175447,2697936
2020-12-16,284562,641504,214499,101637,442756,827237,174135,2686330
2020-12-15,288572,640267,214286,101289,442106,820255,171187,2677962
2020-12-14,286549,640624,214719,101550,441637,804186,171253,2660518
2020-12-11,291346,638333,214697,101473,440941,807811,171213,2665814
2020-12-10,299943,638336,213914,100799,440162,819873,171033,2684060
2020-12-09,292940,638463,214081,101496,439768,812359,171211,2670318
2020-12-04,275643,639056,214199,101915,439533,835273,171423,2677042
2020-12-03,275805,633311,214237,101045,439750,840563,171278,2675989
2020-12-02,276442,631039,213538,100783,439803,853155,171518,2686278
2020-12-01,280082,631046,213563,101208,439551,856220,170806,2692476
2020-11-30,271782,635953,213826,100773,436236,850877,165876,2675323
2020-11-27,278101,635220,213378,100560,440063,846457,163442,2677221
2020-11-26,279084,633063,213221,100080,440130,839575,168355,2673508
2020-11-25,272041,631340,213129,99817,439810,828024,167204,2651365
2020-11-24,273921,634623,213068,99777,437046,812720,167084,2638239
2020-11-20,273847,636911,213008,99208,435988,800860,168193,2628015
2020-11-19,279044,635239,212980,98896,435179,793574,168637,2623549
2020-11-18,278460,633990,212894,98561,434378,786884,166041,2611208
2020-11-17,279011,633835,212731,98393,433113,782811,166405,2606299
2020-11-16,278812,635750,212564,98213,432223,770857,164307,2592726
2020-11-13,273239,636034,212586,98249,431554,765669,163318,2580649
2020-11-12,283136,631927,212328,97923,430701,763119,163708,2582842
2020-11-11,279460,632338,212303,97694,429791,762533,164382,2578501
2020-11-10,279122,632111,212386,96808,428924,780579,166134,2596064
2020-11-09,275826,633849,212571,97151,428713,774586,165990,2588686
2020-11-05,272085,633068,212588,96600,428330,787106,166801,2596578
2020-11-04,273810,629931,212616,97091,429066,793169,166476,2602159
2020-11-03,277881,628994,212893,96701,428895,799540,165935,2610839
2020-11-02,279484,633490,213046,96555,429179,794012,162975,2608741
2020-10-30,272609,635527,213066,96287,425883,791576,162131,2597079
2020-10-29,279542,630568,212970,95522,429527,791394,160563,2600086
2020-10-28,277186,627589,212945,94848,429470,785745,160243,2588026
2020-10-27,278898,625959,212212,94277,428952,770424,159449,2570171
2020-10-26,278181,626792,212215,94062,428432,757463,159685,2556830
2020-10-23,283590,627086,212149,93662,427435,748028,158263,2550213
2020-10-22,290823,624049,211709,93218,426636,742289,159621,2548345
2020-10-21,282535,621925,211779,92999,424033,737043,162830,2533144
2020-10-20,283412,621793,211750,92381,423168,732025,161087,2525616
2020-10-19,283124,620124,211605,92057,422331,718218,162045,2509504
2020-10-16,283820,620014,211666,91872,421358,711735,163264,2503729
2020-10-15,286465,616948,211739,91642,420240,721905,161405,2510344
2020-10-14,282184,615882,211802,91642,419484,721969,160958,2503921
2020-10-13,281945,616753,211850,91479,418595,713547,161429,2495598
2020-10-09,273009,617706,211976,91684,418003,727236,161731,2501345
2020-10-08,272537,611457,212015,91442,417035,730266,160293,2495045
2020-10-07,269384,608407,212090,91253,416227,734944,158641,2490946
2020-10-06,274693,605715,212168,91099,415678,749217,158774,2507344
2020-10-05,266804,605869,212262,91769,415706,746536,159804,2498750
2020-10-02,261883,606181,212259,91804,416265,753818,160948,2503158
2020-10-01,264791,604350,211926,91302,415681,751986,160962,2500998
2020-09-30,256578,604083,212221,90744,413217,744329,158767,2479939
2020-09-29,265790,602558,211926,89343,417024,748623,159341,2494605
2020-09-28,267661,602757,211910,89397,417051,732161,156704,2477641
2020-09-25,266855,605158,212219,89265,417502,725728,158911,2475638
2020-09-24,267359,597663,212059,88887,416055,718975,158253,2459251
2020-09-23,270924,595381,212096,88439,415637,714102,159908,2456487
2020-09-22,275788,593425,212118,88073,414912,710405,161182,2455903
2020-09-21,279781,592896,212069,87644,412470,699722,162056,2446638
2020-09-18,279118,592687,211975,87390,411501,692252,162620,2437543
2020-09-17,281443,590989,211937,87130,410709,686593,163509,2432310
2020-09-16,281404,588853,211930,86840,410036,682147,163547,2424757
2020-09-15,277276,587904,211958,86627,409415,678447,162940,2414567
2020-09-14,275803,587144,212019,86489,408952,669961,163636,2404004
2020-09-11,277213,587592,211970,86400,408690,664845,161868,2398578
2020-09-10,275302,584903,212075,86105,408299,663176,161709,2391569
2020-09-09,270770,582689,212028,85988,408160,666604,161701,2387940
2020-09-08,271618,581314,212071,85571,407693,683634,160636,2402537
2020-09-07,275314,581282,212159,85392,407211,683910,160622,2405890
2020-09-04,269347,583183,212115,85512,407528,703913,160924,2422522
2020-09-03,268072,579259,212051,85236,408157,708791,161417,2422983
2020-09-02,266068,578400,212015,85343,408348,717946,161639,2429759
2020-09-01,271596,578810,212040,85960,407972,727290,161915,2445583
2020-08-31,266867,579961,212364,85022,405679,728366,160291,2438550
2020-08-28,267218,579195,211923,84452,407948,718429,160136,2429301
2020-08-27,270404,577722,211926,83975,407912,713905,158343,2424187
2020-08-26,268407,575981,211866,83343,407615,707407,158875,2413494
2020-08-25,268917,573850,211871,82969,407220,702597,158456,2405880
2020-08-24,272364,572755,211901,82663,406841,689095,156911,2392530
2020-08-21,267304,571203,211913,82611,403979,680845,156429,2374284
2020-08-20,269510,570511,211922,82732,403649,673870,154446,2366640
2020-08-19,270226,570449,211288,82271,404080,666260,153809,2358383
2020-08-18,269016,569760,211327,81813,403388,654306,153446,2343056
2020-08-14,265809,570099,211352,81603,402856,649096,153544,2334359
2020-08-13,267920,566679,211368,81288,402247,647214,154545,2331261
2020-08-12,275095,564532,211377,80966,401682,648580,155036,2337268
2020-08-11,272662,562753,211390,80780,401326,658690,154159,2341760
2020-08-10,275746,561923,211636,80786,401681,653973,152856,2338601
2020-08-07,268380,559907,211486,80893,401679,674275,153767,2350387
2020-08-06,264594,556667,211485,80730,401630,677863,153313,2346282
2020-08-05,264170,555022,211469,80174,402092,682727,153488,2349142
2020-08-04,262311,553016,211498,81147,402178,698282,152034,2360466
2020-08-03,267514,551962,211652,81076,402200,683640,152334,2350378
2020-07-31,254530,552283,211796,80470,400403,692904,151125,2343511
2020-07-30,259818,549326,211411,79054,403373,674380,149375,2326737
2020-07-29,261272,543048,211392,78220,403956,665806,146433,2310127
2020-07-28,265523,540221,211428,78009,403825,654926,146641,2300573
2020-07-27,268748,539679,211399,77573,403487,639620,145851,2286357
2020-07-24,270209,538458,211404,77350,402665,632285,145915,2278286
2020-07-23,277670,535752,211419,76911,402355,624809,145840,2274756
2020-07-22,281329,533236,211439,76677,401857,617952,145512,2268002
2020-07-21,285992,532109,211477,76132,399710,612219,144762,2262401
2020-07-20,285861,532366,211511,75948,399289,604615,144084,2253674
2020-07-17,285170,530892,211431,75833,398716,601098,144368,2247508
2020-07-16,288742,531747,211250,75283,398458,599368,145512,2250360
2020-07-15,284450,529020,211309,75121,398091,598477,146052,2242520
2020-07-14,285622,527996,211323,75177,397919,612343,146183,2256563
2020-07-13,288261,527885,211579,75145,397645,607034,146457,2254006
2020-07-08,275987,526042,211718,75371,397710,625213,144663,2256704
2020-07-07,277949,523110,211814,75247,397827,640091,142973,2269011
2020-07-06,281062,523154,211345,75343,397969,637620,142492,2268985
2020-07-03,277916,521851,211855,75554,399182,645072,143140,2274570
2020-07-02,276493,520805,211701,75176,399293,642782,143414,2269664
2020-07-01,277635,521302,212076,75993,399579,637494,143868,2267947
2020-06-30,267975,523320,212304,75155,397920,643230,144532,2264436
2020-06-29,275402,520502,211687,74784,401570,631095,143991,2259031
2020-06-26,277601,518818,211685,74404,401989,625150,144743,2254390
2020-06-25,279273,514418,211644,74160,401742,617488,144424,2243149
2020-06-24,278848,510185,211683,73619,401607,613495,144275,2233712
2020-06-23,283192,507933,211690,73255,401496,609076,143891,2230533
2020-06-22,287023,506825,211716,72786,399550,598966,144071,2220937
2020-06-19,284159,506798,211745,72325,399815,592217,144377,2211436
2020-06-18,287146,504217,211784,72300,399647,587383,144927,2207404
2020-06-17,289744,502143,211786,72022,399201,581215,144818,2200929
2020-06-16,296252,503567,211778,72029,398927,570550,143122,2196225
2020-06-12,292495,503932,211659,72007,398791,564365,143150,2186399
2020-06-11,293823,501251,211656,71718,398418,562000,142314,2181180
2020-06-10,290901,498849,211830,71594,398175,563640,140118,2175107
2020-06-09,288740,496165,211910,71713,398296,573035,139585,2179444
2020-06-08,285661,494967,212020,72864,398150,567549,139102,2170313
2020-06-05,281837,493842,212137,72999,398386,579720,138832,2177753
2020-06-04,286755,488800,212099,73097,398621,581549,139046,2179967
2020-06-03,284309,484122,212057,73138,399632,583958,139206,2176422
2020-06-02,284593,480553,212103,72987,399950,595294,138586,2184066
2020-06-01,289132,483191,212176,72885,400057,588375,137440,2183256
2020-05-29,289826,484017,212240,72111,397821,589024,136441,2181480
2020-05-28,306215,479472,211960,71978,401515,589748,135908,2196796
2020-05-27,304172,476942,211980,71613,401839,578507,132556,2177609
2020-05-26,305616,474915,212062,71546,401973,564536,132442,2163090
2020-05-22,311757,470928,212119,71526,401983,555429,132359,2156101
2020-05-21,311521,467611,212159,71244,399998,551961,132142,2146636
2020-05-20,312847,463758,212235,71181,399783,546331,131804,2137939
2020-05-19,315747,460509,212240,70908,399668,542053,132540,2133665
2020-05-18,318322,457945,212336,70865,399275,526020,131333,2116096
2020-05-15,311517,456969,212285,71213,399049,520369,130577,2101979
2020-05-14,314686,445832,212206,71125,399006,517135,126417,2086407
2020-05-13,313916,442208,212204,71148,398728,518189,125145,2081538
2020-05-12,315655,438840,212251,71182,398472,529866,124507,2090773
2020-05-11,317259,436794,212493,71174,398646,526657,123716,2086739
2020-05-08,313735,434303,212634,71807,399473,542639,122431,2097022
2020-05-07,313635,427454,212552,71856,399913,544856,122266,2092532
2020-05-06,306497,423786,212579,71902,400819,549476,123806,2088865
2020-05-05,309476,420524,212722,71917,401352,565123,122616,2103730
2020-05-04,313041,420247,212839,72341,401823,558488,121833,2100612
2020-04-30,306586,419391,213056,72784,400418,556748,120118,2089101
2020-04-29,309243,406198,212810,72669,404530,563490,119062,2088002
2020-04-28,313242,396695,212806,72484,405163,558463,118907,2077760
2020-04-27,316993,391382,212818,72481,405533,547352,117175,2063734
2020-04-24,320247,386944,212860,72547,405646,545078,116882,2060204
2020-04-23,319587,378796,212922,72509,406148,542177,117340,2049479
2020-04-22,317800,376484,212950,72390,405875,539677,116107,2041283
2020-04-21,316395,370922,212969,72396,403852,536470,115421,2028425
2020-04-20,315649,367723,212983,72532,403638,533052,113584,2019161
2020-04-17,315387,360542,213030,72681,403656,528198,113445,2006939
2020-04-16,309127,353098,212590,72808,403710,526534,110757,1988624
2020-04-15,307158,345525,212632,72925,403726,538595,110246,1990807
2020-04-14,304973,339825,212617,73117,403679,558697,109220,2002128
2020-04-13,309513,337492,213012,73427,404030,560305,107102,2004881
2020-04-08,295637,331843,213023,73916,405225,581158,103034,2003836
2020-04-07,293289,324486,213011,74024,405326,589983,101128,2001247
2020-04-06,294185,322156,213043,74319,405702,591184,99835,2000424
2020-04-03,290773,318208,213054,74753,407713,594781,96487,1995769
2020-04-02,287792,314046,212970,74825,410134,596593,94364,1990724
2020-04-01,286035,316173,213083,75464,411162,597597,92857,1992371
2020-03-30,271606,319658,213174,75706,408028,600323,90857,1979352
2020-03-27,280238,321711,213021,74790,410091,592444,87896,1980191
2020-03-26,281083,326319,213028,74672,410146,587115,85948,1978311
2020-03-25,276526,325271,213028,74496,410074,575542,84206,1959143
2020-03-20,261511,324093,213033,74482,410027,563411,83298,1929855
2020-03-19,248541,320850,213045,74393,410100,559080,81740,1907749
2020-03-18,236640,309358,213127,74192,409614,557336,81294,1881561
2020-03-17,238261,306367,213113,74172,409261,553658,80602,1875434
2020-03-16,237479,305858,213171,74171,408722,545492,79463,1864356
2020-03-13,223856,304582,213229,74182,408183,537951,79954,1841937
2020-03-12,227087,301840,213180,74133,407329,536841,79413,1839823
2020-03-11,228514,300141,213118,74129,406700,537340,78654,1838596
2020-03-10,234060,297612,213297,74657,406287,548604,78140,1852657
2020-03-09,227772,296911,213403,74913,406073,547738,78166,1844976
2020-03-06,218850,295322,213768,75117,405818,569920,78190,1856985
2020-03-05,219519,293255,213352,75138,405603,574716,77836,1859419
2020-03-04,220347,290937,213408,75378,406147,574474,78006,1858697
2020-03-03,221753,290668,213445,75376,406021,591709,77818,1876790
2020-03-02,223240,292263,213639,75431,405955,586550,75941,1873019
2020-02-28,212489,293173,213779,76109,404308,592781,74979,1867618
2020-02-27,222113,291193,213707,74848,406089,585533,75032,1868515
2020-02-26,229172,293332,213722,74896,407886,573711,73867,1866586
2020-02-21,220362,292609,213838,74977,406325,563337,70369,1841817
2020-02-20,225967,290718,213879,75003,405853,557640,70064,1839124
2020-02-19,228182,289995,213852,75380,405586,552830,69946,1835771
2020-02-18,230089,289711,213852,75378,405022,549882,69398,1833332
2020-02-17,233360,290705,213909,74520,404318,541759,69623,1828194
2020-02-14,223703,291175,213946,75637,403839,536805,70759,1815864
2020-02-13,227443,289234,213867,75685,403272,535803,70553,1815857
2020-02-12,228138,289120,213861,75618,402530,536894,71167,1817328
2020-02-11,223823,288156,213882,75578,401958,552376,71267,1827040
2020-02-10,223100,288604,214054,75722,401603,549665,71278,1824026
2020-02-07,209065,288071,214198,75974,401705,569482,73559,1832054
2020-02-06,209943,285855,214240,76503,401492,572108,71066,1831207
2020-02-05,206586,285047,214319,76572,402049,575297,71307,1831177
2020-02-04,210017,284306,214217,76881,402295,593788,71214,1852718
2020-02-03,214094,286178,214285,76986,402336,591231,70923,1856033
2020-01-31,201149,287870,214545,77564,400779,598708,69062,1849677
2020-01-30,208991,287906,214320,76296,404152,594450,67867,1853982
2020-01-29,213926,286298,214288,76274,404355,590455,67026,1852622
2020-01-28,217118,286162,214353,76800,404527,585280,66574,1850814
2020-01-27,217630,287758,214307,76844,404072,574610,66628,1841849
2020-01-24,220980,289335,214325,76921,403739,565653,67086,1838039
2020-01-23,219787,288862,214355,76913,403692,560483,67022,1831114
2020-01-22,220287,288469,214344,76388,403295,555832,67458,1826073
2020-01-21,223337,289452,214441,76372,401020,552498,67707,1824827
2020-01-20,224242,291454,214429,76409,400618,543748,67903,1818803
2020-01-17,221754,292163,214479,76537,400202,538498,69129,1812762
2020-01-16,226357,290445,214509,76764,399673,534994,69488,1812230
2020-01-15,227403,290721,214535,76786,399353,530236,70256,1809290
2020-01-14,229989,290887,214429,78109,398979,522928,70335,1805656
2020-01-13,233244,293211,214494,78172,398843,522499,70115,1810578
2020-01-10,227356,293916,214713,77126,398735,520192,69972,1802010
2020-01-09,223132,292663,214913,77350,399685,523592,70048,1801383
2020-01-08,219311,291616,214899,77465,399148,529607,70453,1802499
2020-01-07,219827,290623,214948,77973,399102,542903,70962,1816338
2020-01-06,216096,291169,214941,78057,400255,548320,70727,1819565
2020-01-03,217749,292561,214983,78601,400862,569181,70850,1844787
2020-01-02,217782,299148,214869,78701,400862,569063,70679,1851104
2019-12-30,208405,301982,215131,79531,398579,582973,69868,1856469
2019-12-27,215530,302076,215289,78319,402940,567533,69391,1851078
2019-12-26,223290,301163,214919,78394,403060,557611,67045,1845482
2019-12-23,224949,302682,215024,78602,401252,539609,66383,1828501
2019-12-20,224958,302514,214992,78244,401189,528799,66105,1816801
2019-12-19,224989,297763,214924,78782,401635,525464,63457,1807014
2019-12-18,226269,295307,214846,78782,401734,522211,62583,1801732
2019-12-17,227988,293277,214805,78735,401474,519373,62833,1798485
2019-12-16,230396,293201,214789,78820,401758,512385,62354,1793703
2019-12-13,224145,292244,214827,78996,401808,507362,62731,1782113
2019-12-12,233265,289915,214737,79038,402031,501362,63509,1783857
2019-12-11,239702,288517,214700,79016,401830,503252,62444,1789461
2019-12-10,240672,286143,214715,79198,401880,514924,62187,1799719
2019-12-09,238833,285430,214679,79501,402229,512517,62276,1795465
2019-12-06,227549,282199,214451,79641,402308,529663,62519,1798330
2019-12-05,226729,278451,214563,79869,402301,533092,62214,1797219
2019-12-04,222661,275662,214520,80642,403585,537208,61900,1796178
2019-12-03,222455,274859,214658,80531,403939,545428,62220,1804090
2019-12-02,223856,278435,214306,80567,404128,536063,61617,1798972
2019-11-29,210068,278209,214418,81469,402292,540768,58247,1785471
2019-11-28,214462,274534,214006,80420,405815,538320,58487,1786044
2019-11-27,214121,272007,213864,80507,406591,534303,58307,1779700
2019-11-26,213122,271200,213813,80574,406433,530994,58154,1774290
2019-11-25,213518,272582,213744,80649,406207,518393,57630,1762723
2019-11-22,212011,272786,213719,80704,406166,508845,56598,1750829
2019-11-21,213709,271249,213750,80708,404871,503440,56215,1743942
2019-11-20,214837,271862,213800,80836,404579,499391,56487,1741792
2019-11-19,217438,273380,213808,81318,404248,491903,57082,1739177
2019-11-15,217380,274680,213840,81398,404205,486923,57115,1735541
2019-11-14,223628,272207,213977,81523,404022,485180,57051,1737588
2019-11-13,225289,271194,213725,81578,403747,489092,57321,1741946
2019-11-12,223065,271987,213704,81621,403276,499270,56854,1749777
2019-11-11,224563,273221,213834,81721,403011,493279,56942,1746571
2019-11-08,219707,272577,214119,82080,403643,508370,57295,1757791
2019-11-07,219113,271073,214152,82400,403825,511312,57608,1759483
2019-11-05,219930,270326,214019,82525,403944,516821,57667,1765232
2019-11-04,220210,270528,214063,82775,405051,514183,57335,1764145
2019-11-01,226572,271939,214101,82917,405582,518173,56399,1775683
2019-10-31,213327,273100,213994,83776,403945,517861,56134,1762137
2019-10-30,217105,272533,213837,82782,407650,511067,57390,1762364
2019-10-29,222162,272626,213798,82808,408139,503270,57324,1760127
2019-10-28,236119,274185,213842,82819,408458,487704,56525,1759652
2019-10-25,238733,274821,213865,82856,408421,476202,55301,1750199
2019-10-24,235397,267574,213783,82638,408399,469167,51999,1728957
2019-10-23,226993,262840,213755,82606,407938,464635,52452,1711219
2019-10-22,225596,259006,213704,82421,407559,459965,51471,1699722
2019-10-21,223626,258421,213533,82520,405413,448566,48238,1680317
2019-10-18,218082,257535,213495,82591,405229,442300,49150,1668382
2019-10-17,218645,255850,213315,82622,404801,437351,48801,1661385
2019-10-16,221952,254928,213295,83066,404466,433042,49060,1659809
2019-10-15,213219,255860,213362,82998,404263,424766,48755,1643223
2019-10-11,210095,256619,213384,83353,404603,420011,48891,1636956
2019-10-10,207424,255089,213433,83316,404468,419979,49003,1632712
2019-10-09,203217,253425,213528,83563,404859,418748,49095,1626435
2019-10-08,199741,251472,213573,80972,404772,431205,49411,1631146
2019-10-07,203877,251824,213582,83761,404425,430080,49538,1637087
2019-10-04,198578,251407,213579,84365,404747,441881,49603,1644160
2019-10-03,196649,247048,213561,84385,405758,448792,49002,1645195
2019-10-02,199218,245327,213503,84453,406120,454320,49565,1652506
2019-10-01,202123,245858,213559,84550,406508,454152,49033,1655783
2019-09-30,192585,248518,213551,85418,405467,460589,48395,1654523
2019-09-27,197277,245677,213392,84032,408562,454227,47484,1650651
2019-09-26,195801,243375,213407,84036,409368,450317,47117,1643421
2019-09-25,197061,242043,213369,84073,409466,443787,47490,1637289
2019-09-24,196568,241084,213336,84158,409927,438993,47870,1631936
2019-09-23,194038,241862,213256,84201,408244,428298,47756,1617655
2019-09-20,191124,243451,213223,84318,408227,422342,48485,1611170
2019-09-19,192477,240575,213200,84380,408391,418021,48974,1606018
2019-09-18,192237,239729,212992,84392,408125,414378,48896,1600749
2019-09-17,190790,239369,212854,84493,408075,411408,49444,1596433
2019-09-16,191072,240841,212941,84555,407867,404512,49726,1591514
2019-09-13,186209,240851,212846,84762,408000,400664,50944,1584276
2019-09-12,189361,239806,212852,84745,407882,400243,51037,1585926
2019-09-11,189624,239033,212841,84786,407800,402779,51259,1588122
2019-09-10,189053,239441,213011,84571,407788,412546,51652,1598062
2019-09-09,183939,238001,213078,85649,408190,409682,51682,1590221
2019-09-06,175720,237712,213113,85879,408451,423351,51841,1596067
2019-09-05,176114,231542,212616,85922,408544,424300,51478,1590516
2019-09-04,176430,229758,212588,86306,409579,426464,52155,1593280
2019-09-03,181949,229823,212431,86278,409693,435610,52446,1608230
2019-09-02,181737,226896,212442,86311,410076,429478,51434,1598374
2019-08-30,171134,228342,212173,87407,409589,433400,50122,1592167
2019-08-29,173080,225009,212271,85379,412433,430569,50918,1589659
2019-08-28,168409,222509,212246,85317,413055,426423,50718,1578677
2019-08-27,174197,221121,212248,85289,413152,421610,50660,1578277
2019-08-26,172245,222197,212266,85522,413181,413497,50998,1569906
2019-08-23,171063,222540,212302,85528,413227,405926,50032,1560618
2019-08-22,174787,219726,212274,85506,413389,403242,49110,1558034
2019-08-21,175237,220608,212220,85534,411669,399293,48945,1553506
2019-08-20,172489,222749,212238,85543,411361,391319,49630,1545329
2019-08-16,175214,222945,212199,85625,411082,386024,49273,1542362
2019-08-15,174522,221915,212252,85553,410935,385041,49621,1539839
2019-08-14,169318,222689,212266,85597,410878,386194,50582,1537524
2019-08-13,173884,222843,212268,85697,410669,397196,50771,1553328
2019-08-12,173208,223801,212546,85742,411354,392432,50583,1549666
2019-08-09,157586,223070,212625,86074,411782,401817,49753,1542707
2019-08-08,155754,220787,212537,86486,411505,408197,49579,1544845
2019-08-07,151348,219321,212510,86450,410931,411511,49221,1541292
2019-08-06,151989,217588,212456,86615,410990,419519,49318,1548475
2019-08-05,148559,217376,212449,86407,411548,418226,49850,1544415
2019-08-02,149055,217642,212388,87010,412223,423977,49605,1551900
2019-08-01,153794,217449,212415,86961,412453,423826,49757,1556655
2019-07-31,146435,220120,212344,87833,410844,415325,48978,1541879
2019-07-30,149969,218508,212561,86066,414499,415260,47569,1544432
2019-07-29,148600,218577,212424,86014,417600,407533,47171,1537919
2019-07-26,151198,219001,212326,85965,417508,399700,46690,1532388
2019-07-25,154278,218062,212499,86140,417659,397117,46994,1532749
2019-07-24,157182,217535,212495,86037,417633,392499,46959,1530340
2019-07-23,168787,217615,212218,85986,417367,389029,46813,1537815
2019-07-22,163850,219679,212216,86015,415548,382910,46539,1526757
2019-07-19,161585,220295,212300,86025,415357,378273,47063,1520898
2019-07-18,162711,219100,212256,85922,415147,375342,46306,1516784
2019-07-17,165372,218785,212236,85882,414749,372324,46286,1515634
2019-07-16,169920,218740,212250,85882,414453,368903,46578,1516726
2019-07-15,168467,220428,212295,85877,414280,365526,46760,1513633
2019-07-12,163973,220783,212267,85992,414548,366129,47115,1510807
2019-07-11,169726,220021,212312,86346,414448,375970,46872,1525695
2019-07-10,168488,222631,212444,86411,414646,376324,46757,1527701
2019-07-05,153442,222178,212539,86833,415323,384198,46834,1521347
2019-07-04,155328,220069,212488,87379,415667,387648,46576,1525155
2019-07-03,152836,217837,212459,87293,416323,388774,47255,1522777
2019-07-02,157307,219374,212094,87123,416583,397499,46914,1536894
2019-07-01,160227,222839,212515,86502,417032,394626,47000,1540741
2019-06-28,148165,224067,212486,88081,415840,404372,46182,1539193
2019-06-27,151048,220845,212315,86434,419792,402137,46400,1538971
2019-06-26,154854,217765,212115,86250,420137,397667,45209,1533997
2019-06-25,158102,216482,212213,86208,421703,393488,44880,1533076
2019-06-24,160957,217282,212236,86164,421373,379919,44807,1522738
2019-06-21,157782,219082,212258,86571,420100,374086,44904,1514783
2019-06-19,159571,219868,212092,86569,420215,369982,44624,1512921
2019-06-18,158567,222303,212338,86586,420095,362350,44950,1507189
2019-06-14,153231,222865,212377,86909,420250,357204,45244,1498080
2019-06-13,150217,221753,212358,86925,420064,360149,45569,1497035
2019-06-12,153816,220785,212339,86897,419812,363234,45582,1502465
2019-06-11,153021,220944,212393,86856,419602,375076,45549,1513441
2019-06-10,149944,221986,212518,87103,419747,371838,45346,1508482
2019-06-07,139884,220446,212654,87622,420331,379166,46249,1506352
2019-06-06,140668,219418,212627,88171,419794,382724,45159,1508561
2019-06-05,140291,217980,212634,87792,421100,392073,45171,1517041
2019-06-04,143151,217208,212532,88113,421548,397716,45811,1526079
2019-06-03,145505,219211,212499,88137,421773,396049,45561,1528735
2019-05-31,138407,222950,212630,89188,420338,401663,44242,1529418
2019-05-30,140721,221597,212613,88326,424445,396409,44508,1528619
2019-05-29,142070,221396,212417,88154,424992,393334,44189,1526552
2019-05-28,143649,222284,212435,88158,425160,390371,43836,1525893
2019-05-27,144534,224012,212595,88337,425035,382046,43961,1520520
2019-05-24,143274,224276,212523,88389,425085,376585,43736,1513868
2019-05-23,148269,223517,212650,88352,424898,371640,43726,1513052
2019-05-22,149667,223403,212653,88308,424994,367626,44065,1510716
2019-05-21,153196,223254,212561,88269,423387,367420,44262,1512349
2019-05-20,151939,225493,212557,88505,423073,360400,44132,1506099
2019-05-17,150260,225931,212588,88337,422948,356030,44895,1500989
2019-05-16,152461,225496,212488,88292,422653,356274,44720,1502384
2019-05-15,150277,225584,212468,88258,422429,359245,44767,1503028
2019-05-14,150706,224912,212435,88361,422292,368534,45217,1512457
2019-05-13,153116,227364,212263,88714,422043,365813,44800,1514113
2019-05-10,152635,228040,212385,88762,422110,368982,44989,1517903
2019-05-09,146748,226531,212416,88773,422079,375635,45759,1517941
2019-05-08,141034,224695,212391,88753,421734,384181,45764,1518552
2019-05-07,144275,223059,212360,88833,421651,391243,46058,1527479
2019-05-06,143171,223480,212386,88966,422345,387616,46263,1524227
2019-05-03,144919,222705,212334,89362,423013,386357,46315,1525005
2019-05-02,143793,223040,212344,89047,423735,386576,47125,1525660
2019-04-30,138359,226808,212313,90396,422131,395782,45796,1531585
2019-04-29,139043,227904,212330,89305,424806,379821,43827,1517036
2019-04-26,138257,226793,212325,89326,425970,375477,43923,1512071
2019-04-25,142025,225724,212243,89271,426105,372735,43980,1512083
2019-04-24,141169,224421,212200,89183,425867,369337,43844,1506021
2019-04-23,144057,224263,212079,89176,425784,364698,43824,1503881
2019-04-22,145199,228230,212104,89127,424247,356114,43741,1498762
2019-04-17,142304,228472,212169,89249,423966,351133,44295,1491588
2019-04-16,145394,227775,212102,89227,423597,350148,45128,1493371
2019-04-15,144085,229371,212084,89295,423015,349069,45069,1491988
2019-04-12,141809,230409,211946,89529,422756,348341,45436,1490226
2019-04-11,144355,230283,211926,89512,422299,349747,45551,1493673
2019-04-10,143357,229940,212117,89490,422263,358036,45531,1500734
2019-04-09,144698,229177,212225,89963,422290,365235,45431,1509019
2019-04-08,141896,229984,212172,89999,421628,366938,45481,1508098
2019-04-05,137821,229205,212061,90095,421958,373090,45436,1509666
2019-04-04,137262,227946,212048,90450,422070,376663,45741,1512180
2019-04-03,139193,228507,212076,90475,422406,380935,45957,1519549
2019-04-01,138337,232109,212019,90934,422342,380982,45574,1522297
2019-03-29,133950,233504,212203,91588,421593,387256,44755,1524849
2019-03-28,136465,230815,212021,90228,424463,383685,44856,1522533
2019-03-27,138168,229052,211852,90178,424861,382108,44257,1520476
2019-03-26,138573,228535,211860,90145,424824,379383,44275,1517595
2019-03-25,141303,229560,211671,90090,424637,372115,44283,1513659
2019-03-22,140352,229945,211702,90017,424145,365898,44349,1506408
2019-03-21,143322,228817,211675,90005,422697,362173,44515,1503204
2019-03-20,145346,228687,211642,90025,422471,360661,44555,1503387
2019-03-19,147404,228458,211635,90068,422096,359304,45464,1504429
2019-03-18,152348,228999,211556,90088,421585,353494,45626,1503696
2019-03-15,148218,232672,211501,90137,421186,351689,45663,1501066
2019-03-14,148249,228668,211480,90262,420897,355693,45739,1500988
2019-03-13,151637,227585,211486,90304,420432,358720,45699,1505863
2019-03-12,152853,226126,211509,90347,419940,369670,45566,1516011
2019-03-11,151673,226182,211650,90384,419683,369564,45439,1514575
2019-03-08,142404,225331,211603,91020,420136,378749,45561,1514804
2019-03-07,146784,222215,211591,91171,420088,382337,46072,1520258
2019-03-06,148752,223465,211630,91313,420400,382806,46028,1524394
2019-03-01,145232,224759,211648,91779,420849,386479,46648,1527394
2019-02-28,139042,226319,211659,92628,420190,388615,45945,1524398
2019-02-27,141759,226377,211525,91827,422781,381227,45956,1521452
2019-02-26,144062,226206,211480,91818,422962,381595,45763,1523886
2019-02-25,145713,226689,211486,91826,422880,374319,45818,1518731
2019-02-22,144855,226642,211480,91792,422615,369426,46174,1512984
2019-02-21,147122,226388,211564,91717,421158,365103,45775,1508827
2019-02-20,147741,226324,211498,91756,421091,362301,46052,1506763
2019-02-19,147108,225865,211502,91785,420689,357681,46871,1501501
2019-02-18,149784,227131,211528,92017,420191,353861,46876,1501388
2019-02-15,147603,228544,211527,92060,419912,351533,47134,1498313
2019-02-14,146986,228324,211494,92164,419643,354453,48210,1501274
2019-02-13,150051,227938,211452,92196,419208,357963,49042,1507850
2019-02-12,148637,227438,211478,92179,418742,367874,49352,1515700
2019-02-11,148153,229235,211542,92197,418459,367788,49308,1516682
2019-02-08,142554,229225,211619,92548,418888,373949,49541,1518324
2019-02-07,141761,228538,211542,92614,418661,378935,49646,1521697
2019-02-06,142850,228046,211460,92935,418521,383464,49451,1526727
2019-02-05,141921,226940,211463,92999,419080,392426,49708,1534537
2019-02-04,143583,227578,211398,93373,419293,389297,49764,1534286
2019-02-01,142422,228630,211323,93455,419437,391425,49678,1536370
2019-01-31,137305,230682,211386,94276,418770,392290,48502,1533211
2019-01-30,136828,230821,211230,92758,420798,390047,49929,1532411
2019-01-29,138352,230688,211205,92693,421082,387138,49297,1530455
2019-01-28,141612,232171,211203,92681,421046,382070,48962,1529745
2019-01-25,140454,233280,211220,92854,420855,374215,49673,1522551
2019-01-24,141001,232567,211219,92745,421020,369497,49625,1517674
2019-01-23,143012,232045,211198,92661,420694,366410,50578,1516598
2019-01-22,145778,232886,211179,92615,420357,364341,50819,1517975
2019-01-21,147430,235613,211171,92698,418734,359266,51072,1515984
2019-01-18,143753,237262,211057,92749,418493,355479,51394,1510187
2019-01-17,147017,236732,210999,92666,416942,350888,51699,1506943
2019-01-16,148821,237337,210964,92629,416563,349732,51959,1508005
2019-01-15,149296,238568,210905,92615,416215,347293,51897,1506789
2019-01-14,150105,240371,210910,92709,416109,344097,51969,1506270
2019-01-11,151567,241146,210858,92781,415942,346226,51974,1510494
2019-01-10,150395,240537,210787,92858,415784,355360,52060,1517781
2019-01-09,147034,240603,210834,93118,415988,362571,52200,1522348
2019-01-08,144400,240210,210826,93135,415924,369327,52136,1525958
2019-01-07,145107,241881,210809,93306,416005,370409,52295,1529812
2019-01-04,141337,241878,210856,94037,417174,379263,52514,1537059
2019-01-03,146398,240537,210837,94040,417300,376500,52399,1538011
2019-01-02,144582,250450,210857,94067,419192,374998,52199,1546345
2018-12-28,140137,252277,210819,94681,418763,387510,53059,1557246
2018-12-27,147355,251047,210879,96953,421443,372931,49816,1550424
2018-12-26,149016,250609,210858,97002,421689,357478,49468,1536120
2018-12-21,148021,251039,210910,97120,420600,350234,48471,1526395
2018-12-20,153112,249956,210823,97205,420812,349188,48398,1529494
2018-12-19,153713,248511,210764,97274,420747,347426,46682,1525117
2018-12-18,159968,246661,210701,97225,421059,346618,46978,1529210
2018-12-17,161419,248796,210687,97180,420907,342586,46229,1527804
2018-12-14,158201,248837,210690,97294,420960,341238,45886,1523106
2018-12-13,160832,248127,210591,97315,420888,344842,45689,1528284
2018-12-12,164839,247670,210342,97304,420656,349886,45642,1536339
2018-12-11,164420,247497,210263,97279,420591,355409,45719,1541178
2018-12-10,164110,248839,210251,97310,420665,354700,45995,1541870
2018-12-07,158421,248323,210218,97714,421299,360669,46096,1542740
2018-12-06,158117,246772,210088,97746,421587,365483,46171,1545964
2018-12-05,158851,245108,209941,97914,422322,372682,45785,1552603
2018-12-04,162954,246188,209902,98198,421479,374421,47088,1560230
2018-12-03,162365,250633,209796,98221,421722,374670,46508,1563915
2018-11-29,155774,251010,209921,95507,422911,380053,46815,1561991
2018-11-28,155703,249291,209658,98156,423815,374708,46062,1557393
2018-11-27,158580,248324,209563,98106,424101,370999,45786,1555459
2018-11-26,159485,248086,209433,98102,424080,363125,45450,1547761
2018-11-23,156900,248634,209325,97710,423949,355126,45289,1536933
2018-11-22,156969,247674,209279,98042,423876,353746,45853,1535439
2018-11-21,159768,248234,209190,98323,422551,352389,45800,1536255
2018-11-20,158980,250639,209066,98445,422123,348138,45693,1533084
2018-11-16,159203,251786,208999,98649,422045,345861,45818,1532361
2018-11-15,160069,251266,208873,98652,421675,353615,46913,1541063
2018-11-14,160228,250438,208769,98675,421444,356287,47158,1542999
2018-11-13,163773,251212,208677,98768,422185,359348,45938,1549901
2018-11-12,161422,253142,208560,98722,420777,358562,47270,1548455
2018-11-09,154941,253209,208592,99164,422090,365282,46063,1549341
2018-11-08,159074,252313,208502,99162,421670,373492,46484,1560697
2018-11-07,158306,252851,208439,99240,421452,376372,45847,1562507
2018-11-05,157341,254554,208269,99289,421558,375728,44990,1561729
2018-11-02,156185,254147,208177,100013,422966,377303,44942,1563733
2018-11-01,158027,254732,208091,99991,423185,375300,45268,1564594
2018-10-31,152044,257308,208188,97449,421297,373223,48882,1558391
2018-10-30,153520,257705,207985,99567,424543,371088,43103,1557511
2018-10-29,153038,258708,207918,99348,424764,361638,43221,1548635
2018-10-26,155809,259720,207854,99463,424734,358617,43485,1549682
2018-10-25,157981,259388,207713,99434,424518,355870,44116,1549020
2018-10-24,163687,259614,207640,99303,424388,353479,44509,1552620
2018-10-23,164914,260839,207586,99075,424098,348550,44753,1549815
2018-10-22,164970,263688,207540,99447,422758,342225,44953,1545581
2018-10-19,163107,263660,207451,99658,422525,338073,45015,1539489
2018-10-18,167022,262330,207276,99625,422276,336211,45299,1540039
2018-10-17,173140,263363,207117,99633,421776,333606,45993,1544628
2018-10-16,174266,266226,206969,99699,421442,328889,46073,1543564
2018-10-12,169149,267476,206945,99833,421278,327000,46252,1537933
2018-10-11,169766,266779,206835,99807,420932,331127,46379,1541625
2018-10-10,169682,267255,206798,99835,420697,335804,46258,1546329
2018-10-09,169379,267252,206761,100181,420805,341382,46524,1552284
2018-10-08,167000,268028,206706,100285,420543,342125,46445,1551132
2018-10-05,166985,268414,206537,100672,420894,347057,45789,1556348
2018-10-04,170249,266898,206495,101004,421171,349644,46006,1561467
2018-10-03,170909,266344,206381,101001,421679,354289,46078,1566681
2018-10-02,173848,268362,206288,101040,421706,358233,46107,1575584
2018-10-01,172551,271956,206219,101032,421507,354763,47228,1575256
2018-09-28,170488,274341,206196,98951,421380,359919,50320,1581595
2018-09-27,174518,272125,206055,100621,423204,355700,47445,1579668
2018-09-26,175303,270543,205927,100455,423173,351363,47631,1574395
2018-09-25,177212,270675,205752,100136,423135,347283,47745,1571938
2018-09-24,175370,273661,205773,100347,423174,342344,48302,1568971
2018-09-21,174032,274567,205614,100384,422237,338380,48039,1563253
2018-09-20,174893,274334,205573,100426,422031,336464,48393,1562114
2018-09-19,176698,273398,205501,100381,421735,332928,49276,1559917
2018-09-18,178990,273696,205362,100311,421277,331260,48923,1559819
2018-09-17,182401,274862,205224,100309,420906,326511,49436,1559649
2018-09-14,177928,274782,205238,100383,420639,325091,49642,1553703
2018-09-13,178560,273296,205049,100368,420218,328869,49877,1556237
2018-09-12,180792,272470,204881,100307,419911,335279,50006,1563646
2018-09-11,178058,273429,204684,100275,419557,340691,50024,1566718
2018-09-10,176227,275250,204693,100505,419241,337309,49326,1562551
2018-09-07,170486,275676,204684,100912,419647,343762,49542,1564709
2018-09-06,168568,274536,204499,100793,419603,347142,49720,1564861
2018-09-05,167119,273254,204341,100790,419572,353957,50015,1569048
2018-09-04,170762,273111,204318,98615,419663,355581,49111,1571161
2018-09-03,169713,276089,204212,98532,419559,354895,50260,1573260
2018-08-31,162166,279681,203842,98989,419329,359370,52987,1576364
2018-08-30,167935,277845,203920,100981,420627,354391,50343,1576042
2018-08-29,168755,275951,203743,100528,420626,351471,49771,1570845
2018-08-28,169235,275223,203541,100466,420141,344785,50178,1563569
2018-08-27,169506,276378,203368,100392,419701,340638,49967,1559950
2018-08-24,169936,276353,203273,100343,419224,336416,48859,1554404
2018-08-23,174118,274669,203001,100239,418778,333901,50285,1554991
2018-08-22,179398,276502,202790,100204,418411,329516,50463,1557284
2018-08-21,176656,278983,202602,100214,416645,323991,50656,1549747
2018-08-17,173147,278705,202536,100232,416031,319776,50964,1541391
2018-08-16,173304,278125,202225,100131,415377,317411,51824,1538397
2018-08-15,175244,278069,201969,100079,414741,316686,51997,1538785
2018-08-14,175311,278874,201758,100083,414216,314670,52429,1537341
2018-08-13,178298,277679,201603,100098,413639,311196,52169,1534682
2018-08-10,173347,278346,201567,100384,413159,310776,51720,1529299
2018-08-09,173743,279819,201394,100662,412969,314890,51696,1535173
2018-08-08,170373,278313,201108,100586,412442,321283,52247,1536352
2018-08-07,171999,277587,200792,100574,412042,326881,52374,1542249
2018-08-06,170309,278328,200567,100598,411740,326549,52673,1540764
2018-08-03,166713,277880,200423,100882,412131,330893,52434,1541356
2018-08-02,168659,276384,200194,100857,412244,331882,52881,1543101
2018-08-01,171367,277226,200035,100740,412123,336225,53891,1551607
2018-07-31,165524,280342,199905,98784,411685,343042,55106,1554388
2018-07-30,166914,281833,199505,100344,412822,337506,51903,1550827
2018-07-27,165464,281608,199333,100303,412718,334183,52736,1546345
2018-07-26,167510,280829,199114,100217,412695,333217,52788,1546370
2018-07-25,169019,280349,198919,100149,412697,330004,52135,1543272
2018-07-24,171111,280016,198743,100092,412334,324301,52012,1538609
2018-07-23,171234,282400,198513,100010,410846,321294,52220,1536517
2018-07-20,170957,283360,198365,100310,410461,317515,52864,1533832
2018-07-19,171874,282281,198119,100259,410374,314700,52635,1530242
2018-07-18,173393,281332,197861,100190,409854,312568,53103,1528301
2018-07-17,175927,281290,197660,100129,409271,309492,53357,1527126
2018-07-16,177428,281795,197516,100029,408730,306046,53759,1525303
2018-07-13,174057,282295,197393,100123,408488,306513,53582,1522451
2018-07-12,177194,280186,197065,100020,408014,311504,53265,1527248
2018-07-11,175835,280172,196807,99949,407772,316927,53496,1530958
2018-07-10,171370,282388,196710,100008,407611,317014,53399,1528500
2018-07-06,165800,281529,196567,100286,407987,322180,53379,1527728
2018-07-05,166827,279118,196341,100262,408363,324578,53289,1528778
2018-07-04,165571,277425,196001,100525,408473,330343,53502,1531840
2018-07-03,167054,278853,195799,100748,408522,333802,53748,1538526
2018-07-02,166478,282660,195579,100432,408466,334581,53223,1541419
2018-06-29,158068,283699,195491,98628,408335,340915,51763,1536899
2018-06-28,163508,279049,194938,100209,410183,337206,52218,1537311
2018-06-27,164703,276395,194644,100164,410287,335495,51927,1533615
2018-06-26,167606,275745,194328,100081,410118,329816,51450,1529144
2018-06-25,170452,276025,193904,100051,409821,324527,51218,1525998
2018-06-22,164002,278080,193931,100024,409875,321786,50965,1518663
2018-06-21,165113,278487,193554,100070,409040,318787,51389,1516440
2018-06-19,163417,278238,193095,100164,408570,315173,51425,1510082
2018-06-18,162994,280237,192927,100067,408098,310997,51977,1507297
2018-06-15,162892,280372,192725,100043,407755,309050,51849,1504686
2018-06-14,165451,279714,192329,100059,407353,311630,51500,1508036
2018-06-13,164747,278713,192035,100034,406835,317983,51448,1511795
2018-06-12,164905,278800,191765,99951,406291,320064,50939,1512715
2018-06-11,160197,280278,191526,99876,405938,317616,51112,1506543
2018-06-08,156170,280040,191160,99990,405973,322620,51238,1507191
2018-06-07,157805,277342,190758,99981,405667,326117,50996,1508666
2018-06-06,159277,275915,190453,99912,405428,333397,50710,1515092
2018-06-05,157675,276525,190160,99839,405600,335059,50591,1515449
2018-06-04,155838,276374,189989,99848,405571,332851,51008,1511479
2018-06-01,156057,278526,189730,99840,405568,333917,50968,1514606
2018-05-31,152606,280024,189543,99680,404890,336042,50245,1513030
2018-05-30,154023,279888,188338,99505,406324,330223,49874,1508175
2018-05-29,156607,278242,187503,99357,406040,324869,49793,1502411
2018-05-28,156927,280616,186839,99200,405574,319012,49939,1498107
2018-05-24,157247,280680,186328,99199,405165,316477,50280,1495376
2018-05-23,158164,280138,185705,98615,404851,313308,50663,1491444
2018-05-22,160117,280411,185052,98443,403165,311629,51088,1489905
2018-05-21,157500,282943,184659,98579,402752,306300,50690,1483423
2018-05-18,156810,283299,184194,98616,402162,301876,51138,1478095
2018-05-17,158023,282078,183501,98388,401492,297472,51810,1472764
2018-05-16,164043,282076,182894,98211,400791,296436,52289,1476740
2018-05-15,165949,283773,182430,98263,400300,293913,52220,1476848
2018-05-14,166280,285050,181990,98316,399895,290704,52490,1474725
2018-05-11,165581,285515,181614,98152,399317,290348,52381,1472908
2018-05-10,163988,284276,181135,98236,398736,294563,52412,1473346
2018-05-09,161253,282561,180625,98154,398427,301638,51723,1474381
2018-05-08,158762,283194,180168,98250,397591,306450,51981,1476396
2018-05-07,160016,282869,179835,98184,397126,306460,52004,1476494
2018-05-04,156411,281840,179519,98129,397640,310757,51870,1476166
2018-05-03,161174,281487,179031,97960,397385,314210,52768,1484015
2018-05-02,156794,285762,178639,97924,396787,311166,51665,1478737
2018-04-27,152173,286311,178417,96224,396055,317082,51080,1477342
2018-04-26,155128,283313,176723,97672,397143,312514,50998,1473491
2018-04-25,154209,282116,175170,97497,396690,310879,50767,1467328
2018-04-24,154572,281364,173978,97277,395185,307723,50503,1460602
2018-04-23,154151,282329,172985,97088,394422,301760,50087,1452822
2018-04-20,154845,283821,172198,97214,393566,298498,50387,1450529
2018-04-19,154324,281844,171244,97112,392761,296266,50382,1443933
2018-04-18,158968,280778,170274,96843,392068,294644,50007,1443582
2018-04-17,158180,281811,170024,96642,391650,292586,49752,1440645
2018-04-16,156501,283924,169800,96521,390600,288474,50116,1435936
2018-04-13,153334,282787,169058,96479,389925,288088,50409,1430080
2018-04-12,155348,281120,168464,96410,389138,290884,50414,1431778
2018-04-11,154966,281058,167916,96207,388452,296593,50269,1435461
2018-04-10,154634,280665,167384,96155,387621,300248,50092,1436799
2018-04-09,150974,279757,166823,96377,386904,301856,50043,1432734
2018-04-06,146528,278702,166187,96315,386841,307711,50214,1432498
2018-04-05,144796,278674,166104,96096,386042,310416,50382,1432510
2018-04-04,147383,278709,165341,96314,385907,306336,50579,1430569
2018-04-03,143688,284615,164955,96328,385247,307568,50444,1432845
2018-03-28,140152,284944,164691,94545,386514,312562,49822,1433230
2018-03-27,144435,281944,163696,95220,386457,305207,49123,1426082
2018-03-26,143817,281016,162695,94988,386039,300067,48318,1416940
2018-03-23,143304,280872,162056,94825,385500,296874,47357,1410788
2018-03-22,144857,278957,161201,94600,384825,294775,47669,1406884
2018-03-21,145521,277993,160414,94491,383521,292372,47475,1401787
2018-03-20,146270,278623,159769,94441,382668,290445,47799,1400015
2018-03-19,145591,279311,159140,94320,381803,286716,48367,1395248
2018-03-16,147824,279521,158502,94176,380974,285464,48696,1395157
2018-03-15,149643,278678,157749,94068,380114,287483,48218,1395953
2018-03-14,147635,277788,156956,93933,379355,292199,48407,1396273
2018-03-13,149693,277939,156344,93798,378545,294786,47798,1398903
2018-03-12,148057,279204,155790,93658,378332,292104,47230,1394375
2018-03-09,143408,278699,155254,93929,377884,295206,47444,1391824
2018-03-08,141022,276847,154439,93556,377079,298455,47506,1388904
2018-03-07,142387,275114,153568,93597,376302,302614,47537,1391119
2018-03-06,144794,274105,152879,93326,375197,305226,47638,1393165
2018-03-05,142593,274203,152330,93234,375008,303317,48000,1388685
2018-03-02,140947,273384,151754,93444,374922,304176,48154,1386781
2018-03-01,142966,274912,150952,92838,374744,302174,48691,1387277
2018-02-28,139895,276295,150393,93232,374300,303745,49877,1387737
2018-02-27,140641,274685,149546,92897,375017,301577,49228,1383591
2018-02-26,141381,275075,148957,92650,373176,295526,48415,1375180
2018-02-23,143445,274487,148349,92543,372629,292982,48788,1373223
2018-02-22,146474,273879,147507,91998,371914,291428,49336,1372536
2018-02-21,144465,273248,146677,91859,370501,288433,49873,1365056
2018-02-20,146882,272705,145978,91688,369811,286645,50038,1363747
2018-02-19,143860,273667,145962,91634,369324,284484,49876,1358807
2018-02-16,142916,274522,145872,91407,369023,288710,50276,1362726
2018-02-15,148335,275317,145092,91317,368155,287091,50946,1366253
2018-02-14,141557,277956,144471,91131,367348,287847,51265,1361575
2018-02-09,135515,278367,144100,91315,366785,292068,50721,1358871
2018-02-08,132340,278930,143922,91144,366541,295824,50566,1359267
2018-02-07,132934,276438,143201,91178,366203,300977,50753,1361684
2018-02-06,133937,276258,142441,91055,365481,304059,50714,1363945
2018-02-05,133248,276376,141867,90988,365440,303600,50400,1361919
2018-02-02,132396,276618,141416,91195,365254,305325,50493,1362697
2018-02-01,132176,276797,140967,91048,364758,308956,50206,1364908
2018-01-31,130175,279013,140539,89472,365687,302865,50503,1358254
2018-01-30,132181,278472,139984,90404,364417,303145,49544,1358147
2018-01-29,131148,279472,139433,90319,363943,304517,49652,1358484
2018-01-26,132568,279637,138556,90139,363314,295491,49714,1349419
2018-01-25,134679,278475,138295,90127,362788,293077,49641,1347082
2018-01-24,136715,277959,137730,90110,362400,290696,49728,1345338
2018-01-23,136598,278461,137178,90335,360879,288784,49888,1342123
2018-01-22,135888,280913,136693,90013,360163,284441,50240,1338351
2018-01-19,133588,280951,136317,89988,359427,281009,50546,1331826
2018-01-18,134672,279948,135759,89852,359042,279038,51237,1329548
2018-01-17,135136,279051,135252,89593,358021,277622,51787,1326462
2018-01-16,137846,279951,134762,89399,357249,275786,51884,1326877
2018-01-15,135740,282713,134319,89246,356497,272242,51869,1322626
2018-01-12,134551,282965,133959,89208,355905,271807,52292,1320687
2018-01-11,135983,282280,133388,89017,355235,277560,52610,1326073
2018-01-10,135867,282267,132663,88872,354629,279685,52873,1326856
2018-01-09,133649,282064,132143,89029,353864,284096,53163,1328008
2018-01-08,130988,282312,131712,89270,353340,285639,53299,1326560
2018-01-05,127377,282470,131413,88792,352943,289847,53769,1326611
2018-01-04,125614,281167,130963,89158,352818,291947,53580,1325247
2018-01-03,128300,282124,130405,89045,352460,294071,53928,1330333
2018-01-02,124222,287972,129639,88927,351999,293088,53972,1329819
2017-12-29,119778,289107,129823,88513,351780,293120,54605,1326726
2017-12-28,123827,286185,128923,89008,352072,290040,53392,1323447
2017-12-27,130294,283628,127733,88246,351740,286204,53696,1321541
2017-12-26,130341,283900,126846,88019,351058,279964,51853,1311981
2017-12-22,131443,283581,126204,87907,350519,274169,50294,1304117
2017-12-21,134700,281207,125025,87675,349220,272255,49115,1299197
2017-12-20,134905,279954,124165,86977,349205,269705,49234,1294145
2017-12-19,140241,277879,123325,86847,348698,268516,49569,1295075
2017-12-18,140768,278899,122971,86698,348308,265050,49746,1292440
2017-12-15,134967,278292,122366,86620,348313,264603,49341,1284502
2017-12-14,134966,276081,121655,86466,347315,269104,49397,1284984
2017-12-13,132464,274325,121016,86346,346442,271494,49597,1281684
2017-12-12,133955,274022,120324,86207,345796,273737,49536,1283577
2017-12-11,132053,274343,119814,86132,344956,272815,49382,1279495
2017-12-07,129743,273320,119455,86388,344703,278134,48132,1279875
2017-12-06,129304,270872,118771,86278,343969,283321,47334,1279849
2017-12-05,128612,269300,117949,86444,343936,287347,47395,1280983
2017-12-04,127964,269062,117359,86582,343646,284664,47417,1276694
2017-12-01,127120,270050,116847,86508,343082,284936,46295,1274838
2017-11-30,123188,271838,116515,86101,342292,285494,46133,1271561
2017-11-29,125639,269469,115526,85640,342631,282228,47221,1268354
2017-11-28,126298,268638,115040,85295,342086,278489,47289,1263135
2017-11-27,126022,269496,114552,85111,341235,274826,46507,1257749
2017-11-24,128478,269314,114161,84906,340402,270260,46186,1253707
2017-11-23,128801,267170,113589,84674,339551,268613,46169,1248567
2017-11-22,130442,266675,113097,84521,338813,264659,46333,1244540
2017-11-21,126112,268859,112643,84582,337126,260194,46858,1236374
2017-11-17,123287,268608,112258,84489,336114,257217,46404,1228377
2017-11-16,125247,267359,111684,84282,335200,255439,46812,1226023
2017-11-15,127256,266720,111086,84044,333924,255320,46913,1225263
2017-11-14,128028,265500,110608,83976,333097,253875,47314,1222398
2017-11-13,129021,266414,110111,83627,332187,251301,47143,1219804
2017-11-10,125910,266928,109758,84015,331459,249980,47094,1215144
2017-11-09,125280,263874,109215,84103,330882,254910,47137,1215401
2017-11-08,129298,262403,108607,83874,329809,259782,46981,1220754
2017-11-07,128100,262628,108209,83474,328800,260870,46904,1218985
2017-11-03,121265,261660,107730,83633,328654,263638,45905,1212485
2017-11-02,119983,259579,107214,83422,328739,266658,46148,1211743
2017-11-01,123265,258859,106721,83505,328188,266185,46111,1212834
2017-10-31,119545,260360,106041,83342,327323,269451,46101,1212163
2017-10-30,119882,260361,105417,82530,327539,267188,45318,1208235
2017-10-27,118648,259719,105029,82329,326869,264926,44991,1202511
2017-10-26,120623,258444,104545,82142,326124,262803,45078,1199759
2017-10-25,121788,256955,104076,81973,325347,260121,45362,1195622
2017-10-24,123018,256437,103580,81820,324393,256872,45439,1191559
2017-10-23,120980,257909,103175,81605,322784,252524,45845,1184822
2017-10-20,120751,258789,102886,81715,322163,247644,45323,1179271
2017-10-19,120961,256705,102328,81531,320701,245616,45883,1173725
2017-10-18,124083,256815,101810,81384,320143,243454,46096,1173785
2017-10-17,123974,258045,101376,81196,319717,239444,46371,1170123
2017-10-13,119906,258170,101123,81148,318949,237867,46492,1163655
2017-10-12,121322,256359,100669,81063,317877,239929,46394,1163613
2017-10-11,119749,255547,100202,80845,317031,244163,46473,1164010
2017-10-10,119565,255545,99870,80710,316143,245916,46661,1164410
2017-10-09,116958,255545,99508,80748,315434,245941,46938,1161072
2017-10-06,113827,254716,99146,80973,314906,250273,46324,1160165
2017-10-05,115128,253193,98546,80675,314233,251638,46209,1159622
2017-10-04,114470,251241,98079,80573,314198,256053,46370,1160984
2017-10-03,114935,251240,97690,80369,313613,259003,46510,1163360
2017-10-02,113935,254513,97347,80235,312933,256990,46150,1162103
2017-09-29,110594,255250,96755,80308,311322,256973,46330,1157532
2017-09-28,112218,252517,96017,79417,311933,255618,45872,1153592
2017-09-27,113794,250780,95458,79132,311618,254379,45664,1150825
2017-09-26,115510,250249,94845,78904,310977,250997,45647,1147129
2017-09-25,116573,250617,94520,78684,310233,248561,45301,1144489
2017-09-22,113885,250352,94312,78500,309548,243462,44866,1134925
2017-09-21,113121,249100,93808,78335,308239,242823,44847,1130273
2017-09-20,114151,248338,93420,78220,307655,240141,45094,1127019
2017-09-19,113643,247493,93086,78064,306756,237900,45445,1122387
2017-09-18,114409,248730,92747,77875,305830,235029,45654,1120274
2017-09-15,113120,249340,92449,77639,305042,233696,45574,1116860
2017-09-14,113657,247231,91945,77332,304207,235627,45677,1115676
2017-09-13,113632,245862,91482,77159,303334,240830,45780,1118079
2017-09-12,113399,245371,91145,76979,302480,242703,45851,1117928
2017-09-11,111149,246118,90863,76858,301778,241877,45707,1114350
2017-09-08,107650,245254,90620,76924,301312,247182,44882,1113824
2017-09-07,107376,243191,90141,76727,300491,248619,44908,1111453
2017-09-06,107318,241527,89726,76535,299957,249747,45045,1109855
2017-09-05,105596,240310,89347,76404,299712,254049,44924,1110342
2017-09-04,105067,240224,88753,76391,299271,255374,45014,1110094
2017-09-01,104409,241050,88453,76702,298781,256723,45062,1111180
2017-08-31,103437,241642,88092,76600,298004,257725,44894,1110394
2017-08-30,104062,240112,87439,75362,298458,254553,45101,1105087
2017-08-29,105249,238634,86958,75101,297992,251685,44658,1100277
2017-08-28,105586,239319,86661,74811,297387,248403,44600,1096767
2017-08-25,106557,239080,86443,74612,296777,243250,44580,1091299
2017-08-24,108532,237473,86006,74051,295987,241075,44825,1087949
2017-08-23,111543,237153,85621,73829,295618,237504,45152,1086420
2017-08-22,109639,237433,85332,73719,294333,234751,45415,1080622
2017-08-18,106495,237308,85150,73608,293844,231624,45876,1073905
2017-08-17,108937,235548,84702,73417,292796,229885,46255,1071540
2017-08-16,113323,234484,84328,73238,292078,228395,46247,1072093
2017-08-15,111207,234319,84012,73096,291321,226401,46285,1066641
2017-08-14,111769,235583,83773,72959,290585,224586,46596,1065851
2017-08-11,110514,235537,83449,72844,290031,223900,46424,1062699
2017-08-10,109173,233871,83052,72847,289491,225664,46280,1060378
2017-08-09,108127,232169,82692,72656,288852,231125,46321,1061942
2017-08-08,108249,231135,82418,72478,288182,235228,46358,1064048
2017-08-07,106940,231319,82218,72293,287553,235308,46383,1062014
2017-08-04,105589,230611,81996,72498,287419,238300,46509,1062922
2017-08-03,105163,228095,81903,72371,287384,240840,46486,1062242
2017-08-02,104888,227100,81639,72212,286918,244065,46673,1063495
2017-08-01,106038,227686,81422,72041,286867,245548,46087,1065689
2017-07-31,102526,230350,81013,71667,285724,246371,45825,1063476
2017-07-28,103924,229497,80652,71359,285913,244496,45956,1061797
2017-07-27,105381,228304,80133,71183,285799,242404,44880,1058084
2017-07-26,105330,227528,79944,71024,285313,240488,45104,1054731
2017-07-25,106176,227088,79730,70869,284782,237324,45314,1051283
2017-07-24,106499,228036,79297,70669,284190,234939,45224,1048854
2017-07-21,103395,228381,79149,70587,283391,232088,45482,1042473
2017-07-20,105095,226937,78910,70600,283007,230421,46030,1041000
2017-07-19,106533,225756,78640,70356,282683,228125,46212,1038305
2017-07-18,108724,225502,78427,70174,281975,226094,46367,1037263
2017-07-17,110242,226955,78273,70071,281353,222696,45984,1035574
2017-07-14,108736,226880,78107,69912,280893,222253,46005,1032786
2017-07-13,110004,225382,77743,69823,280289,223870,45704,1032815
2017-07-12,110570,224403,77454,69615,279660,227870,45672,1035244
2017-07-11,109745,223673,77259,69458,279184,230146,45385,1034850
2017-07-10,109981,223852,77125,69384,278599,229665,45665,1034271
2017-07-07,104570,223425,76939,69523,278597,234885,45519,1033458
2017-07-06,104624,221269,76683,69385,277991,237851,44687,1032490
2017-07-05,103531,219668,76425,69145,278060,242145,44485,1033459
2017-07-04,103264,219023,76309,69444,277834,245517,45163,1036554
2017-07-03,104315,219429,74801,68673,277454,244229,44709,1033610
2017-06-30,97448,223293,75872,69346,277470,248510,44857,1036796
2017-06-29,99732,219735,75563,69587,278115,248375,43493,1034600
2017-06-28,99806,216068,75193,68690,277904,245363,42602,1025626
2017-06-27,100914,214805,74875,68448,277480,242974,42627,1022123
2017-06-26,102419,214181,74633,68271,276883,239404,42828,1018619
2017-06-23,101799,212952,74505,68150,276678,238189,43295,1015568
2017-06-22,103183,211686,74317,67941,276199,235083,43581,1011990
2017-06-21,105206,211785,74183,67941,275413,232450,43241,1010219
2017-06-19,104927,212157,74033,67818,274798,229730,42725,1006188
2017-06-16,104712,212104,73931,67505,274352,228527,42420,1003551
2017-06-15,105320,211309,73691,67518,273547,229904,42365,1003654
2017-06-14,106498,209885,73433,67349,273328,233653,42691,1006837
2017-06-13,106902,209390,73071,67169,272606,235118,42705,1006961
2017-06-12,105280,210663,72933,67021,272160,234399,42295,1004751
2017-06-09,104663,210010,72833,67283,271529,236877,42436,1005631
2017-06-08,100494,208350,72617,66910,271399,240459,41861,1002090
2017-06-07,101106,206915,72420,66741,270926,243320,41620,1003048
2017-06-06,100805,205593,72275,66576,270313,244410,41655,1001627
2017-06-05,98811,205775,72193,66434,270477,245809,41774,1001273
2017-06-02,97764,205382,72116,66528,270803,247664,41725,1001982
2017-06-01,98353,205307,72018,66395,270560,246862,41515,1001010
2017-05-31,96834,206604,72006,66458,269832,244928,41112,997774
2017-05-30,101036,206859,71641,64872,269901,244381,41585,1000275
2017-05-29,100779,207402,71527,64614,269588,240772,41629,996311
2017-05-26,101176,207485,71465,64391,269105,238187,41455,993264
2017-05-24,101027,206575,71318,64227,268524,236787,41235,989693
2017-05-23,104892,206055,71130,64091,268068,232560,40797,987593
2017-05-22,104809,207647,71011,64068,267018,230800,40774,986127
2017-05-19,100126,207524,70951,63928,266337,228165,40619,977650
2017-05-18,102024,205957,70632,63654,265531,226097,40644,974539
2017-05-17,106906,204951,70277,63511,264715,224499,40487,975346
2017-05-16,108675,204871,70124,63362,264222,222589,40519,974362
2017-05-15,109793,206177,69950,63188,263567,220587,40227,973489
2017-05-12,108915,206104,69759,63106,263042,221133,40605,972664
2017-05-11,109926,204968,69594,62976,262364,225413,39972,975213
2017-05-10,109652,204636,69424,62796,261779,227368,39942,975597
2017-05-09,109936,203565,69373,62818,261320,230461,39469,976942
2017-05-08,107889,203523,69252,62686,260483,231556,38935,974324
2017-05-05,106375,203134,69106,62550,260403,234867,39097,975532
2017-05-04,103985,201760,68884,62697,260558,236915,39180,973979
2017-05-03,106099,201844,68751,62542,260218,240161,39271,978886
2017-05-02,106808,205189,68645,62405,259857,239161,39191,981256
2017-04-28,103376,205629,68719,62284,259517,239481,39023,978029
2017-04-27,103721,203752,68363,61826,259909,239109,38976,975656
2017-04-26,103830,202572,68213,61636,259257,238286,38011,971805
2017-04-25,105843,201995,68051,61466,258687,234932,38325,969299
2017-04-24,103036,202680,67940,61304,258071,232187,38421,963639
2017-04-21,104278,202587,67846,61200,256966,228670,38375,959922
2017-04-20,105809,201996,67599,61134,256319,227521,38496,958874
2017-04-19,107669,200808,67501,61019,255832,225308,38840,956977
2017-04-18,108980,201152,67403,60896,254937,224617,38865,956850
2017-04-17,110247,203705,67192,60773,254187,222252,38982,957338
2017-04-12,107169,203131,67214,60783,253548,228628,38673,959146
2017-04-11,105953,201849,67020,60654,252729,230324,38805,957334
2017-04-10,105446,202501,66930,60480,252019,230754,38710,956840
2017-04-07,100834,201903,66901,60565,251795,234970,38638,955606
2017-04-06,104111,200189,66742,60398,251450,237781,38403,959074
2017-04-05,102274,200318,66765,60388,251609,239739,38531,959624
2017-04-04,103875,199133,66613,60512,251086,241317,38598,961134
2017-04-03,104991,200460,66527,60309,250458,239264,38474,960483
2017-03-31,100921,201752,66544,60248,249809,241219,38855,959348
2017-03-30,103452,200156,66263,59874,250013,240167,37940,957865
2017-03-29,104197,198091,66119,59624,249655,237840,37505,953031
2017-03-28,102573,197967,65958,59393,249014,234556,37313,946774
2017-03-27,103211,199423,65830,59217,248404,229727,37227,943039
2017-03-23,107407,198442,65769,59086,247771,228182,37215,943872
2017-03-22,106857,197153,65623,58860,247225,226841,36799,939358
2017-03-21,107944,196870,65523,58753,246014,225548,36958,937610
2017-03-20,108373,197622,65416,58675,245392,222970,37075,935523
2017-03-17,107921,197836,65367,58604,244689,222592,36838,933847
2017-03-16,110331,197521,65279,58433,243919,225115,36939,937537
2017-03-15,112336,197304,65176,58270,243218,229065,37155,942524
2017-03-14,113161,196987,65096,58124,242347,231298,38058,945071
2017-03-13,112921,197969,64991,58009,241587,230378,38164,944019
2017-03-10,110407,197950,64948,57956,241064,235459,38165,945949
2017-03-09,109035,196608,64884,58035,240667,237445,37967,944641
2017-03-08,111402,195484,64751,57942,239985,240206,37715,947485
2017-03-07,110901,194650,64594,57814,239292,241692,37928,946871
2017-03-06,111147,194613,64523,57757,238858,241363,37825,946086
2017-03-03,109448,194045,64494,57961,238961,241760,38174,944843
2017-03-02,113789,194394,64298,57832,238602,240082,38243,947240
2017-03-01,112334,199057,64233,57752,238212,236425,38193,946206
2017-02-24,109407,200002,64320,57841,237904,236906,37294,943674
2017-02-23,112816,198709,64041,57531,237813,234191,36259,941360
2017-02-22,111096,197742,63881,57262,237646,232075,36496,936198
2017-02-21,111801,197961,63728,57116,236732,230364,36391,934093
2017-02-20,111504,199075,63716,57078,236162,228057,36775,932367
2017-02-17,110817,198857,63589,56973,235591,226302,37252,929381
2017-02-16,112055,199070,63548,56768,235123,225216,37461,929241
2017-02-15,113153,198825,63376,56639,234439,224288,37534,928254
2017-02-14,113674,198352,63311,56555,233863,223592,37725,927072
2017-02-13,115683,198590,63243,56439,232779,222130,38048,926912
2017-02-10,112481,198193,63227,56338,232442,222617,38062,923360
2017-02-09,110443,196722,63201,56808,232222,226017,37313,922726
2017-02-08,109309,195745,63120,56669,231725,231138,37834,925540
2017-02-07,109938,195257,63045,56563,231178,233413,37606,927000
2017-02-06,108714,195377,62985,56452,230852,233592,37878,925850
2017-02-03,105634,194857,62985,56637,231125,237071,37739,926048
2017-02-02,106693,193975,62883,56488,230813,239236,38097,928185
2017-02-01,105489,193827,62781,56300,230646,241599,37855,928497
2017-01-31,104237,195319,62884,56033,230004,243733,37660,929870
2017-01-30,105715,196881,62556,55869,230254,242204,36812,930291
2017-01-27,103516,196957,62440,55770,230099,240558,36653,925993
2017-01-26,104798,196389,62334,55571,229578,238927,36747,924344
2017-01-25,105435,196098,62215,55445,229057,236025,36847,921122
2017-01-24,106035,196116,62082,55200,228506,233297,37193,918429
2017-01-23,104788,197629,62053,54993,227685,229166,37519,913833
2017-01-20,104069,197924,62042,54977,227106,227798,37498,911414
2017-01-19,104654,196895,61972,54742,226529,226990,37821,909603
2017-01-18,107227,196381,61909,54558,226179,225078,38092,909424
2017-01-17,109592,196516,61783,54333,225605,223740,38452,910021
2017-01-16,112496,198532,61754,54188,225051,221434,38683,912138
2017-01-13,108117,198335,61832,54119,224457,221624,38538,907022
2017-01-12,107956,197226,61694,53986,223910,223563,38712,907047
2017-01-11,106884,196775,61526,53854,223432,226498,38795,907764
2017-01-10,106716,197087,61448,53739,222927,228139,38799,908855
2017-01-09,106475,197320,61463,53786,222811,227681,38876,908412
2017-01-06,101898,197358,61418,53723,222633,232182,38858,908070
2017-01-05,104365,196450,61362,53607,222266,233199,39019,910268
2017-01-04,102192,195319,61269,53699,221938,236159,39006,909582
2017-01-03,104046,195953,61207,53628,221669,238149,38849,913501
2017-01-02,103505,199492,61154,53538,221398,236248,38726,914061
2016-12-30,101125,201346,61219,53200,221358,237283,38701,914232
2016-12-29,103172,199777,60956,53294,221297,235272,38628,912396
2016-12-28,106077,196902,60568,53022,220938,233210,38446,909163
2016-12-27,107811,195406,60302,52740,220586,230823,38033,905701
2016-12-26,112353,194764,60095,52545,220313,225370,38489,903929
2016-12-23,112135,193946,60050,52382,219972,219034,37673,895192
2016-12-22,114048,192298,59792,52217,219721,220391,37097,895564
2016-12-21,113415,191274,59510,52010,218911,218213,36967,890300
2016-12-20,114824,190314,59357,51866,218605,216639,36759,888364
2016-12-19,115858,190018,59238,51738,218222,214378,36704,886156
2016-12-16,114770,189180,59136,51659,217584,214832,36687,883848
2016-12-15,109679,187952,58914,51540,217079,219906,36226,881296
2016-12-14,106195,186469,58757,51478,216637,219822,36346,875704
2016-12-13,108762,186157,58637,51295,216179,220250,35972,877252
2016-12-12,106267,187544,58620,51212,215719,220888,36230,876480
2016-12-07,102055,186313,58584,51561,215506,225968,35712,875699
2016-12-06,104073,184858,58465,51454,215133,226438,35834,876255
2016-12-05,102647,184277,58372,51352,215175,225977,36005,873805
2016-12-02,101049,183741,58287,51435,215169,226413,35821,871915
2016-12-01,104100,183479,58142,51275,214920,225913,35823,873652
2016-11-30,102246,184327,58163,51146,214586,224610,35803,870881
2016-11-29,105439,184633,57923,50998,214436,220985,35103,869517
2016-11-25,101293,184959,57887,50882,214186,217547,34893,861647
2016-11-24,102230,183803,57754,50674,213791,216194,34968,859414
2016-11-23,101245,183112,57649,50457,213574,214287,34897,855221
2016-11-22,103658,182752,57566,50303,213327,212247,34834,854687
2016-11-21,100566,183412,57536,49592,212418,209488,34137,847149
2016-11-18,98526,182936,57522,49485,211751,207960,34206,842386
2016-11-17,100922,181760,57511,49339,211088,206477,34412,841509
2016-11-16,102519,181253,57412,49239,210374,205035,34507,840339
2016-11-15,107135,181471,57362,49102,209820,204085,34539,843514
2016-11-14,105481,182045,57276,49023,209229,202236,34838,840128
2016-11-11,106584,182290,57234,48955,208636,202546,34400,840645
2016-11-10,106865,181432,57174,48806,208133,204822,33886,841118
2016-11-09,108179,180710,57197,48826,207771,208034,33772,844489
2016-11-08,107938,180043,56972,48721,207219,210424,33705,845022
2016-11-07,107460,180161,56940,48662,206559,209742,33725,843249
2016-11-04,105846,179823,56951,48843,206732,211066,33410,842671
2016-11-03,105851,178408,56948,48723,206555,212787,33484,842756
2016-11-02,106893,177152,56877,48661,206346,214344,33723,843996
2016-11-01,109863,176249,56838,48501,205851,213323,33834,844459
2016-10-31,106642,177830,56939,48264,205390,214873,34035,843973
2016-10-28,105473,177970,56727,48187,205631,212692,33621,840301
2016-10-27,107153,177757,56718,48045,205625,211281,33673,840252
2016-10-26,109200,177167,56641,47805,205222,209368,33284,838687
2016-10-25,113037,176557,56574,47649,204823,207125,33416,839181
2016-10-24,112341,176752,56516,47483,204352,203058,33747,834249
2016-10-21,106777,177234,56468,47332,203523,201641,33767,826742
2016-10-20,108093,176914,56442,47306,202984,200534,33825,826098
2016-10-19,108358,176210,56390,47214,202688,199261,34221,824342
2016-10-18,110793,176106,56371,47090,202258,197362,34257,824237
2016-10-17,112354,177392,56349,46981,201613,194361,34389,823439
2016-10-14,110851,177421,56311,46902,201104,195114,34550,822253
2016-10-13,110532,176285,56256,46845,200509,198201,34549,823177
2016-10-12,112078,176193,56220,46751,199969,198183,34562,823956
2016-10-11,109410,177799,56258,46674,199520,198238,34644,822543
2016-10-07,104995,176959,55914,46689,199426,202241,34759,820983
2016-10-06,106503,176430,56278,46619,198991,203861,34918,823600
2016-10-05,102701,175734,56248,46682,198977,206607,35060,822009
2016-10-04,103277,175962,56221,46778,198873,208037,35646,824794
2016-10-03,105262,177266,56215,46696,198451,206383,35566,825839
2016-09-30,98543,178965,56341,46464,198332,207891,35346,821882
2016-09-29,100854,178039,56146,46414,198502,206203,34862,821020
2016-09-28,102086,177193,56084,46239,198382,204062,34682,818728
2016-09-27,103184,177008,56008,46067,198055,202341,34872,817535
2016-09-26,106107,177641,55984,45953,197600,198508,35139,816932
2016-09-23,103145,177892,55971,45893,197234,196703,34912,811750
2016-09-22,103966,177625,55847,45750,196760,195254,35041,810243
2016-09-21,102732,177158,55852,45623,196046,194067,35099,806577
2016-09-20,101658,177884,55775,45608,195589,192615,34989,804118
2016-09-19,102376,178302,55748,45495,194833,190678,35463,802895
2016-09-16,102167,178494,55721,45426,194276,190293,35552,801929
2016-09-15,104976,177815,55705,45341,193704,192208,35654,805403
2016-09-14,105366,177025,55692,45271,193315,195219,35853,807741
2016-09-13,107173,176980,55683,45203,192722,195806,35648,809215
2016-09-12,107058,178106,55692,45119,192256,194864,35810,808905
2016-09-09,103678,178150,55739,45231,192097,197876,35519,808290
2016-09-08,103909,177131,55700,45155,191623,200317,35593,809428
2016-09-07,103177,176576,55581,45062,191221,203011,35503,810131
2016-09-06,102662,175947,55584,44959,190822,204660,35284,809918
2016-09-05,101424,176071,55556,44864,190847,204120,35380,808262
2016-09-02,99357,175731,55584,45021,191009,204644,35436,806782
2016-09-01,101387,175171,55605,44878,190797,202995,35359,806192
2016-08-31,97864,176005,55597,44723,190569,203504,35485,803747
2016-08-30,100181,175674,55528,44682,190778,203291,35123,805257
2016-08-29,99703,175997,55467,44553,190625,200509,34899,801753
2016-08-26,101462,175971,55465,44469,190319,198169,34954,800809
2016-08-25,101492,175777,55416,44328,189950,197019,34578,798560
2016-08-24,103121,175616,55441,44199,189688,194280,34838,797183
2016-08-23,102282,175897,55415,44029,189295,191111,34686,792715
2016-08-22,103571,177273,55419,44051,188534,189840,34790,793478
2016-08-19,100575,177675,55416,43967,188098,187971,35285,788987
2016-08-18,102306,176917,55383,43883,187558,187088,35406,788541
2016-08-17,105746,177267,55314,43758,187125,184975,35424,789609
2016-08-16,108050,178690,55354,43683,186641,182959,35510,790887
2016-08-12,103745,178714,55336,43680,186266,182861,35217,785819
2016-08-11,102984,178077,55327,43574,185863,184926,35341,786092
2016-08-10,104135,177691,55299,43499,185578,187704,35171,789077
2016-08-09,104218,177515,55349,43544,185375,189430,35185,790616
2016-08-08,104572,177865,55363,43475,185081,189891,35173,791420
2016-08-05,102110,177651,55385,43451,185077,192491,35025,791190
2016-08-04,104899,176632,54992,43579,185033,194140,34904,794179
2016-08-03,105136,175714,55268,43486,185021,196560,35024,796209
2016-08-02,106272,176149,55280,43412,184886,199002,35036,800037
2016-08-01,105676,178190,55292,43344,184682,197074,34812,799070
2016-07-29,101970,178464,55325,43194,184417,197599,34927,795896
2016-07-28,101746,176944,55278,43264,184599,196691,35314,793836
2016-07-27,101177,176102,55269,43136,184392,194989,35538,790603
2016-07-26,103029,176069,55251,42988,184088,192923,35887,790235
2016-07-25,104309,177113,55281,42899,183772,189563,36447,789384
2016-07-22,103987,177492,55307,42858,183471,187411,36865,787391
2016-07-21,103549,176960,55285,42772,182873,186511,36782,784732
2016-07-20,104125,177303,55289,42798,182633,184829,36905,783882
2016-07-19,104430,177173,55295,42777,182267,183753,37064,782759
2016-07-18,105719,177848,55319,42713,181816,181276,37198,781889
2016-07-15,105017,178632,55330,42703,181316,181659,37251,781908
2016-07-14,105174,177484,55332,42628,181120,185247,37193,784178
2016-07-13,105214,176682,55338,42611,180759,186682,37336,784622
2016-07-12,104030,176689,55255,42580,180368,188106,37846,784874
2016-07-11,104230,177687,55297,42528,180047,189486,37998,787273
2016-07-07,102979,176863,55302,42601,180079,192930,37897,788651
2016-07-06,103109,175787,55305,42571,180041,196275,37998,791086
2016-07-05,101570,175292,55330,42527,180052,198956,38052,791779
2016-07-04,103331,175223,55337,42630,180053,197894,38137,792605
2016-07-01,101462,176334,55284,42624,180329,199594,38219,793846
2016-06-30,98269,177825,55423,42575,180218,203353,38176,795839
2016-06-29,98120,175852,55095,42427,180617,201962,37189,791262
2016-06-28,97699,174407,54897,42291,180621,200172,36960,787047
2016-06-27,99124,174284,54912,42210,180431,197531,36893,785385
2016-06-24,100385,173619,54923,42205,180251,196303,36932,784618
2016-06-23,102521,172268,54990,42143,180004,194087,36899,782912
2016-06-22,105648,172699,54960,42058,179959,189131,37499,781954
2016-06-21,102248,174681,54928,42089,179286,187414,37907,778553
2016-06-16,103205,174832,54986,42082,178933,185382,38254,777674
2016-06-15,104037,174383,54903,41875,178597,184910,38343,777048
2016-06-14,103994,174021,54785,41758,178410,183884,38093,774945
2016-06-13,104203,174395,54759,41584,178179,182007,38313,773440
2016-06-10,103337,174643,54725,41561,177724,182433,38312,772735
2016-06-09,102637,173909,54699,41589,177618,185071,38032,773555
2016-06-08,100622,173199,54676,41551,177331,189344,37922,774645
2016-06-07,101165,172929,54699,41512,177190,190131,38094,775720
2016-06-06,101586,173012,54712,41486,177274,190840,38106,777016
2016-06-03,98470,173031,54761,41619,177774,193611,38254,777520
2016-06-02,99206,172120,54737,41562,177636,196000,37873,779134
2016-06-01,99542,172248,54752,41513,177564,198516,37794,781929
2016-05-31,96143,174195,54856,41367,177472,198854,37905,780792
2016-05-30,100860,175255,54682,41398,177833,197892,37526,785446
2016-05-27,98892,175790,54712,41351,177782,196413,36843,781783
2016-05-26,100400,175981,54671,41261,177547,193750,36947,780557
2016-05-24,99597,176498,54730,41224,177498,190130,37238,776915
2016-05-23,99570,176927,54744,41156,176862,187100,37406,773765
2016-05-20,96941,177750,54791,41252,176570,185579,37499,770382
2016-05-19,99374,177372,54775,41184,176193,184480,37951,771329
2016-05-18,102064,177295,54720,41081,175863,182750,38044,771817
2016-05-17,102228,177656,54749,40977,175556,179595,37920,768681
2016-05-16,104277,178872,54741,40948,175295,179427,38023,771583
2016-05-13,102846,179065,54754,40980,175036,179801,37921,770403
2016-05-12,101886,178375,54705,40937,174647,181043,37825,769418
2016-05-11,101101,178037,54709,40826,174397,183959,37905,770934
2016-05-10,101067,177914,54753,40775,174024,185224,37878,771635
2016-05-09,99828,178533,54798,40819,173927,184327,37978,770210
2016-05-06,96112,178505,54796,40800,173944,188000,37888,770045
2016-05-05,97312,177564,54791,40715,173868,188891,37963,771104
2016-05-04,96364,176913,54781,40815,174004,191837,37865,772579
2016-05-03,97816,177102,54759,40753,173943,193014,37919,775306
2016-05-02,98284,179330,54756,40690,173765,191625,38265,776715
2016-04-29,93438,180201,54883,40598,174040,193016,38107,774283
2016-04-28,94062,179042,54772,40596,174085,191310,37770,771637
2016-04-27,93891,178056,54755,40481,173950,190326,37354,768813
2016-04-26,96057,177754,54756,40422,173844,187197,37647,767677
2016-04-25,97520,178572,54763,40348,173622,184837,37513,767175
2016-04-22,96169,179518,54765,40292,173517,182957,37301,764519
2016-04-21,96853,179447,54781,40233,172748,181967,37337,763366
2016-04-20,96070,179634,54763,40307,173006,180834,36847,761461
2016-04-19,97591,178963,54752,40229,172656,180184,37189,761564
2016-04-18,97368,179583,54767,40212,172263,178768,37388,760349
2016-04-15,96442,180266,54772,40193,171856,178060,37263,758852
2016-04-14,97306,179402,54736,40124,171504,179450,37411,759933
2016-04-13,98571,179165,54663,40087,171416,182193,37114,763209
2016-04-12,98167,179366,54676,40060,171089,183406,37116,763880
2016-04-11,97156,179884,54709,40026,170718,182106,37157,761756
2016-04-08,95236,179903,54789,40153,170646,185386,37063,763176
2016-04-07,94226,178922,54812,40129,170746,186129,37125,762089
2016-04-06,93880,178528,54810,40116,170493,188427,37050,763304
2016-04-05,92660,178286,54777,40091,170558,189504,37622,763498
2016-04-04,93550,178522,54801,40218,170557,189514,37227,764389
2016-04-01,95272,178652,54838,40244,170697,190755,37509,767967
2016-03-31,92281,179281,54838,40118,170539,191436,37390,765883
2016-03-30,93667,178131,54839,40125,170849,188282,36657,762550
2016-03-29,95190,178195,54840,40063,170692,186662,36185,761827
2016-03-28,96270,179725,54883,40000,170610,182311,36564,760363
2016-03-23,95859,180222,54921,40039,170434,181332,36668,759475
2016-03-22,97556,180027,54904,39990,170153,179879,36559,759068
2016-03-21,98303,180763,54874,40027,169595,178034,36746,758342
2016-03-18,95928,180693,54910,39974,169392,177833,36928,755658
2016-03-17,98906,179829,54863,39933,168985,179244,37107,758867
2016-03-16,99839,179548,54837,39909,168621,181403,37309,761466
2016-03-15,100773,180012,54834,39933,168239,182507,37278,763576
2016-03-14,99682,180524,54855,39921,167983,181285,37377,761627
2016-03-11,98584,181008,54908,39954,167752,183807,37328,763341
2016-03-10,98816,180436,54940,39946,167289,184624,37381,763432
2016-03-09,97113,179857,54966,40030,167169,186699,37424,763258
2016-03-08,97552,179293,54974,39999,166885,189089,37466,765258
2016-03-07,97615,179605,54949,39974,166580,187314,37496,763533
2016-03-04,97751,179142,54958,40133,166648,188660,37650,764942
2016-03-03,95583,177802,54957,40061,166578,189266,37938,762185
2016-03-02,95675,176822,54938,40050,166506,188342,37876,760209
2016-03-01,98810,176854,54929,40014,166348,187277,38039,762271
2016-02-29,95760,178437,54967,40071,166261,186849,37772,760117
2016-02-26,96845,178404,55066,40014,166724,183962,37362,758377
2016-02-25,96055,177963,55039,39962,166828,182416,37308,755571
2016-02-24,96292,177420,55039,39942,166591,181507,37276,754067
2016-02-23,96602,177215,55035,39937,166141,180328,37415,752673
2016-02-22,97986,178185,55033,40012,165859,178297,37649,753021
2016-02-19,97395,178625,55061,40041,165645,176919,37792,751478
2016-02-18,98145,178387,55051,40001,165362,176523,38061,751530
2016-02-17,99347,177727,55033,39947,165081,175732,38036,750903
2016-02-16,101731,177625,55027,39922,164794,175888,38104,753091
2016-02-15,100800,178727,55028,39928,164485,174413,38103,751484
2016-02-12,98382,179166,54992,39985,164313,175237,37848,749923
2016-02-11,99334,179071,54985,39992,164019,178738,37778,753917
2016-02-10,100428,180958,55036,40013,163614,178729,37664,756442
2016-02-05,94027,181581,55128,40167,163843,181937,37546,754229
2016-02-04,97498,178915,55122,40310,163806,183111,37845,756607
2016-02-03,98064,178289,55097,40291,163854,185590,37948,759133
2016-02-02,97868,178600,55106,40298,163716,186663,38097,760348
2016-02-01,99207,180917,55131,40261,163632,185693,38084,762925
2016-01-29,96107,181899,55141,40273,163674,187445,37893,762432
2016-01-28,97251,181391,55126,40216,163875,186301,38823,762983
2016-01-27,96656,181440,55069,40165,163740,184589,38584,760243
2016-01-26,99692,181261,55076,40151,163612,182935,38743,761470
2016-01-25,101680,181807,55083,40132,163381,180009,38759,760851
2016-01-22,100367,182245,55065,40130,163283,178561,38846,758497
2016-01-21,101266,182191,55088,40105,162819,177689,39073,758231
2016-01-20,100890,182497,55083,40165,162670,177045,39258,757608
2016-01-19,101066,182800,55078,40174,162362,176019,39645,757144
2016-01-18,101503,184342,55098,40153,161990,174179,39892,757157
2016-01-15,100450,185892,55124,40136,161772,174533,39810,757717
2016-01-14,98045,185636,55121,40121,161542,176359,39841,756665
2016-01-13,98669,185231,55107,40120,161375,179690,39783,759975
2016-01-12,98690,185275,55102,40097,161140,180623,39915,760842
2016-01-11,96178,186318,55138,40075,160959,180540,40300,759508
2016-01-08,92917,186498,55232,40197,161171,183870,40383,760268
2016-01-07,92553,185581,55214,40199,161141,185032,40512,760232
2016-01-06,91371,185220,55259,40189,161197,187920,40722,761878
2016-01-05,92490,186171,55268,40171,161147,188753,40826,764826
2016-01-04,91000,190472,55262,40279,161138,187703,40911,766765
2015-12-31,87025,191719,55321,40232,161123,190011,40772,766203
2015-12-30,89511,191850,55333,40194,162068,186375,40230,765561
2015-12-29,90853,192289,55169,40115,162124,184255,40175,764980
2015-12-28,89979,193454,54993,40098,161894,180760,40022,761200
2015-12-24,91402,193826,54912,40133,161995,179808,39856,761932
2015-12-23,93084,194029,54856,40103,162108,177573,39813,761566
2015-12-22,95165,193566,54708,40016,162021,175290,39908,760674
2015-12-21,95759,194525,54538,40051,161662,173258,39543,759336
2015-12-18,95755,194754,54463,40069,161510,171370,39414,757335
2015-12-17,95133,193366,54215,40002,161299,170684,39853,754552
2015-12-16,96006,192371,54103,39899,160939,169857,39966,753141
2015-12-15,96890,191933,54069,39838,160460,168982,39908,752080
2015-12-14,94694,191570,53988,39784,160190,168139,40038,748403
2015-12-11,96407,191284,53962,39795,159943,168556,39840,749787
2015-12-10,98787,190725,53755,39758,159592,172042,39796,754455
2015-12-09,96092,191245,53695,39860,159438,171066,39782,751178
2015-12-04,94791,190313,53685,39984,159658,173130,39764,751325
2015-12-03,93868,187234,53509,40018,159564,174982,39571,748746
2015-12-02,92410,184996,53408,39953,159402,174764,39562,744495
2015-12-01,94791,184426,53372,39899,159292,174800,39310,745890
2015-11-30,91193,186684,53320,39828,159100,175072,47282,752479
2015-11-26,92402,185238,53299,39772,159746,171464,46833,748754
2015-11-25,93207,184282,53104,39612,159739,169439,46486,745869
2015-11-24,91725,184340,53059,39552,159211,167075,46424,741386
2015-11-23,90738,183918,53015,39455,158814,164427,46456,736823
2015-11-20,88738,183248,52977,39507,158424,162853,46454,732201
2015-11-19,89816,182070,52869,39422,158044,161414,46674,730309
2015-11-18,90374,180538,52707,39359,157632,160185,46178,726973
2015-11-17,91510,180117,52587,39125,157171,159001,46177,725688
2015-11-16,92153,180880,52541,39034,156650,157090,46253,724601
2015-11-13,89196,180729,52538,39007,156342,157039,46339,721190
2015-11-12,89291,179430,52470,38924,155927,158107,46211,720360
2015-11-11,89264,178448,52366,38855,155535,159508,46178,720154
2015-11-10,91117,177975,52345,38790,155210,160787,46158,722382
2015-11-09,87442,179321,52297,38832,154990,161053,46719,720654
2015-11-05,86274,179106,52289,38757,155006,163066,46662,721160
2015-11-04,84976,177349,52185,38823,155000,163136,46679,718148
2015-11-03,84782,176509,52140,38735,154825,163973,46792,717756
2015-11-02,85117,176678,52098,38639,154564,162398,46712,716206
2015-10-30,82648,177075,52104,38530,154683,163761,46547,715348
2015-10-29,83195,175385,51974,38485,154934,161792,45989,711754
2015-10-28,82660,174746,51926,38367,154763,160343,45818,708623
2015-10-27,84058,174268,51919,38253,154528,158625,45881,707532
2015-10-26,84693,174330,51897,38200,154190,155915,45928,705153
2015-10-23,84518,174265,51868,38158,153850,153612,46044,702315
2015-10-22,84525,173305,51805,38001,153863,153085,46089,700673
2015-10-21,84979,172037,51710,37954,153499,151435,46232,697846
2015-10-20,86186,171493,51681,37965,153060,150037,46239,696661
2015-10-19,86250,171675,51673,37895,152667,148083,46271,694514
2015-10-16,86335,171742,51650,37823,152240,148156,46240,694186
2015-10-15,88820,171299,51656,37737,151801,150093,46276,697682
2015-10-14,90976,170498,51573,37686,151448,150405,45872,698458
2015-10-13,89635,171335,51553,37617,151090,149484,45931,696645
2015-10-09,86484,171335,51487,37700,151050,151595,45856,695507
2015-10-08,85322,170270,51419,37642,150684,153426,45724,694487
2015-10-07,84542,169179,51336,37601,150391,155292,45504,693845
2015-10-06,85443,168583,51313,37541,150216,155818,45457,694371
2015-10-05,84448,168463,51302,37465,150116,153571,45504,690869
2015-10-02,82516,167772,51319,37539,150172,155217,45541,690076
2015-10-01,82871,167697,51238,37396,149947,154343,45440,688932
2015-09-30,80508,168854,51218,37287,149604,154039,45372,686882
2015-09-29,81966,167141,51152,37190,149706,152152,44966,684273
2015-09-28,80873,166700,51097,37079,149496,149427,44663,679335
2015-09-25,80904,166668,51092,37047,149335,147481,44473,677000
2015-09-24,81604,165884,50987,36962,149028,146410,44600,675475
2015-09-23,83960,165390,50963,36833,148732,145130,44618,675626
2015-09-22,85507,165088,50935,36711,148352,143369,44697,674659
2015-09-21,85924,165606,50930,36714,147800,141140,44822,672936
2015-09-18,83989,165646,50933,36694,147442,140112,45025,669841
2015-09-17,84352,164937,50844,36614,147034,139347,45098,668226
2015-09-16,86085,164598,50776,36546,146860,138721,45167,668753
2015-09-15,87242,164720,50743,36476,146424,137798,45194,668597
2015-09-14,86580,164586,50730,36406,146108,136284,45225,665919
2015-09-11,85966,164583,50751,36390,145734,136362,44963,664749
2015-09-10,86167,164096,50738,36327,145429,137742,44964,665463
2015-09-09,84442,163101,50795,36381,145241,140010,44930,664900
2015-09-08,83988,162633,50763,36304,144776,140943,44853,664260
2015-09-07,84163,162745,50721,36258,144501,140910,44934,664232
2015-09-04,82987,162568,50691,36353,144561,142201,44901,664262
2015-09-03,82150,161093,50596,36297,144482,143359,44987,662964
2015-09-02,82229,160008,50545,36216,144246,145332,45070,663646
2015-09-01,83561,159940,50549,36108,144017,145461,45323,664959
2015-08-31,81974,161557,50545,36036,143935,145906,45117,665070
2015-08-28,82580,160395,50585,36022,143826,143700,44848,661956
2015-08-27,84076,158897,50561,35935,143644,143104,44718,660935
2015-08-26,85220,158331,50485,35849,143321,141677,44574,659457
2015-08-25,87084,157747,50434,35768,143042,139894,44500,658469
2015-08-24,86715,157737,50423,35694,142882,136819,44547,654817
2015-08-21,84208,158125,50438,35635,142390,135809,44458,651063
2015-08-20,84358,157419,50418,35683,142027,134732,44454,649091
2015-08-19,84935,157287,50412,35667,141781,133063,44631,647776
2015-08-18,85557,158704,50429,35619,141382,131241,44686,647618
2015-08-14,83565,159010,50460,35605,141105,130938,44723,645406
2015-08-13,84512,158202,50456,35554,140762,131957,44816,646259
2015-08-12,84138,157261,50493,35529,140431,134188,44858,646898
2015-08-11,83829,156865,50496,35496,140129,134351,44787,645953
2015-08-10,82638,157154,50541,35480,139857,134303,45002,644975
2015-08-07,81135,157008,50608,35544,139909,136974,45095,646273
2015-08-06,80441,156073,50608,35483,139705,137501,45147,644958
2015-08-05,79883,155529,50607,35425,139682,139415,45141,645682
2015-08-04,79915,155013,50615,35474,139638,140113,45204,645972
2015-08-03,79782,155515,50617,35416,139446,139057,45320,645153
2015-07-31,77679,156640,50631,35408,139429,138698,45352,643837
2015-07-30,78431,155332,50475,35309,139654,138680,45340,643221
2015-07-29,79269,154456,50331,35236,139419,137083,45179,640973
2015-07-28,80603,154022,50185,35151,139201,135774,45405,640341
2015-07-27,81282,154090,50140,35115,138917,133556,45602,638702
2015-07-24,82377,153536,50093,35050,138765,131610,44993,636424
2015-07-23,84165,152346,50055,34970,138434,130480,45170,635620
2015-07-22,84126,151885,50047,34907,138107,129442,45292,633806
2015-07-21,83879,151351,50005,34842,137637,128658,45489,631861
2015-07-20,83974,151404,49970,34870,137329,127488,45588,630623
2015-07-17,83905,151376,49990,34870,137043,127581,45781,630546
2015-07-16,85541,149681,49952,34828,136796,130296,45473,632567
2015-07-15,87118,149465,49946,34806,136473,131195,45527,634530
2015-07-14,86968,148957,49945,34780,136254,131773,45639,634316
2015-07-13,88782,148826,49930,34788,135974,131014,45292,634606
2015-07-10,87219,149004,49979,34788,135788,132830,45199,634807
2015-07-08,85960,148437,50018,34880,135694,135466,45084,635539
2015-07-07,85193,147765,49953,34859,135507,137257,45041,635575
2015-07-06,83830,147266,49957,34843,135383,135567,45053,631899
2015-07-03,82518,147045,49912,34982,135688,136888,44919,631952
2015-07-02,82014,146309,49862,34878,135632,137799,44848,631342
2015-07-01,83177,146805,49834,34931,135471,137498,44769,632485
2015-06-30,79405,148549,49813,34812,135322,139601,44697,632199
2015-06-29,80497,146934,49547,34726,135660,138163,44347,629874
2015-06-26,80675,145906,49421,34599,135711,137171,44184,627667
2015-06-25,81474,145120,49328,34515,135569,135718,43874,625598
2015-06-24,82597,143881,49262,34445,135457,135107,43944,624693
2015-06-23,82915,143430,49186,34352,135247,133584,43978,622692
2015-06-22,83059,144168,49165,34387,134976,131358,43914,621027
2015-06-19,80171,144189,49063,34362,134761,130007,43916,616469
2015-06-18,80430,143269,48982,34308,134562,128820,44008,614379
2015-06-17,79062,142739,48955,34244,134293,128373,44044,611710
2015-06-16,79882,142737,48921,34204,134042,127378,44187,611351
2015-06-15,78624,143528,48930,34137,133785,126330,44259,609593
2015-06-12,77266,143522,48942,34136,133630,126516,44210,608222
2015-06-11,77589,142662,48912,34056,133395,127755,44049,608418
2015-06-10,76975,142448,48922,34023,133182,129770,43909,609229
2015-06-09,77280,142213,48933,34091,133042,130739,43876,610174
2015-06-08,75726,142876,48920,34096,132889,130771,43827,609105
2015-06-05,74573,142740,48876,34078,132869,132436,43622,609194
2015-06-04,74477,141733,48805,34150,132817,134095,43669,609746
2015-06-03,73776,141016,48742,34085,132760,134567,43678,608624
2015-06-02,74449,141093,48721,34130,132718,135710,43526,610347
2015-06-01,74453,143047,48670,34058,132609,134685,43318,610840
2015-05-29,72609,143543,48695,33930,132569,135385,43338,610069
2015-05-28,74396,141634,48651,33925,132488,133919,42928,607941
2015-05-27,76054,141254,48637,33907,132529,131931,42490,606802
2015-05-26,76434,141919,48665,33850,132656,129846,42458,605828
2015-05-22,74703,141746,48685,33832,132591,128122,42041,601720
2015-05-21,75222,140619,48584,33774,132144,127476,41857,599676
2015-05-20,75456,140483,48582,33808,131862,126425,41817,598433
2015-05-19,76296,140170,48570,33770,131547,125369,41826,597548
2015-05-18,77031,140604,48523,33728,131158,123914,41862,596820
2015-05-15,76718,141673,48480,33708,130930,123996,41766,597271
2015-05-14,76741,140943,48450,33668,130669,125663,41327,597461
2015-05-13,76910,140425,48416,33643,130175,127751,41387,598707
2015-05-12,78656,140203,48406,33613,129790,128317,41411,600396
2015-05-11,76329,140887,48437,33579,129778,127652,41442,598104
2015-05-08,73302,140582,48486,33668,129838,130260,41371,597507
2015-05-07,72224,139490,48435,33616,129655,132031,41595,597046
2015-05-06,70513,138706,48400,33598,129661,132957,41659,595494
2015-05-05,71497,138668,48383,33567,129664,133149,41759,596687
2015-05-04,72027,139355,48353,33630,129559,132529,41455,596908
2015-04-30,70007,140594,48369,33620,129537,132640,41317,596084
2015-04-29,70715,139645,48350,33575,129574,132279,41384,595522
2015-04-28,71645,139079,48278,33516,129482,130119,41397,593516
2015-04-27,72763,140013,48268,33448,129223,128762,41485,593962
2015-04-24,74605,139815,48247,33404,129332,126672,41452,593527
2015-04-23,73732,139511,48225,33313,129055,126032,41485,591353
2015-04-22,74028,139008,48189,33258,128661,125108,41541,589793
2015-04-21,74338,138665,48177,33228,128368,123640,41574,587990
2015-04-20,73292,139474,48209,33267,128045,122572,41484,586343
2015-04-17,73795,138924,48247,33269,127763,121713,41636,585347
2015-04-16,75246,138185,48229,33215,127349,121338,41623,585185
2015-04-15,75742,138205,48181,33171,127057,120865,41605,584826
2015-04-14,76036,138088,48186,33125,126799,120596,41669,584499
2015-04-13,77690,138115,48201,33117,126473,119994,41730,585320
2015-04-10,76613,138029,48224,33108,126377,122563,41616,586530
2015-04-09,75251,137122,48256,33182,126264,124733,41567,586375
2015-04-08,75437,136311,48222,33137,126046,125694,41627,586474
2015-04-07,74904,136166,48180,33121,125925,126657,41614,586567
2015-04-06,74968,137071,48195,33099,125921,127184,41692,588130
2015-04-01,74459,137215,48152,33224,125959,128285,41624,588918
2015-03-31,74062,137779,48128,33150,125943,129879,41501,590442
2015-03-30,72622,138255,48160,33149,125866,127654,41395,587101
2015-03-27,72475,137285,48147,32889,125796,126420,40625,583637
2015-03-26,73339,136942,48067,32808,125740,124168,40758,581822
2015-03-25,73978,137458,48073,32795,125663,121491,40882,580340
2015-03-20,73365,136946,48067,32897,125422,120274,40887,577858
2015-03-19,73130,136031,48061,32850,125144,119752,40957,575925
2015-03-18,73397,135514,47993,32804,124827,118246,41094,573875
2015-03-17,75429,135060,47950,32773,124513,117901,41095,574721
2015-03-16,75661,135373,47941,32753,124245,116534,41220,573727
2015-03-13,76685,135400,47937,32779,123978,116508,41320,574607
2015-03-12,75808,134760,47926,32740,123735,117585,41142,573696
2015-03-11,75454,134397,47917,32706,123473,119821,41028,574796
2015-03-10,75115,134251,47904,32694,123270,120362,41039,574635
2015-03-09,74754,134253,47925,32771,123117,119896,41052,573768
2015-03-06,72929,134158,47925,32770,123098,122118,41065,574063
2015-03-05,73934,133338,47915,32749,122999,122166,40977,574078
2015-03-04,74510,132477,47902,32816,123060,124520,41042,576327
2015-03-03,75440,132307,47839,32795,122860,124838,41037,577116
2015-03-02,75798,133293,47853,32791,122735,123425,40778,576673
2015-02-27,73759,133782,47877,32760,122899,124065,40788,575930
2015-02-26,73540,132531,47883,32804,123053,122142,40577,572530
2015-02-25,74112,131687,47883,32769,122918,120987,40435,570791
2015-02-24,74823,131399,47901,32766,122840,119784,40613,570126
2015-02-23,73825,131497,47914,32732,122484,117810,40603,566865
2015-02-20,72838,132162,47905,32715,122298,116261,40491,564670
2015-02-19,73212,132311,47874,32691,122042,115643,40527,564300
2015-02-18,72684,133859,47887,32666,121765,114860,40513,564234
2015-02-13,71789,134203,47929,32719,121575,115254,40549,564018
2015-02-12,71346,133570,47892,32696,121306,115253,40344,562407
2015-02-11,71082,133047,47876,32696,121041,117294,40679,563715
2015-02-10,70782,133149,47914,32679,120837,118113,40642,564116
2015-02-09,70178,133293,47947,32763,120731,117794,40503,563209
2015-02-06,68507,133214,47975,32766,120567,119858,40731,563618
2015-02-05,69333,132699,47969,32762,120458,120715,40726,564662
2015-02-04,69263,132111,47981,32731,120464,122288,40667,565505
2015-02-03,69320,131942,47949,32681,120336,122607,40737,565572
2015-02-02,69814,132966,47963,32676,120258,122273,40607,566557
2015-01-30,68145,133737,47951,32847,120316,122204,40405,565605
2015-01-29,68296,133203,47869,32642,120477,122077,40121,564685
2015-01-28,69411,132830,47866,32577,120344,120880,40076,563984
2015-01-27,70527,132960,47869,32552,120184,119834,40179,564105
2015-01-26,71200,133541,47882,32532,120095,117195,40246,562691
2015-01-23,73239,133649,47885,32518,119979,116245,40170,563685
2015-01-22,73558,133195,47877,32482,119720,115598,40432,562862
2015-01-21,74617,132948,47876,32446,119433,115040,40394,562754
2015-01-20,73838,133506,47882,32498,119186,114284,40557,561751
2015-01-19,73468,134039,47899,32486,118999,113255,40711,560857
2015-01-16,73634,134477,47828,32476,118834,113313,40672,561234
2015-01-15,74242,134227,47798,32444,118564,113696,40850,561821
2015-01-14,73267,134061,47799,32449,118379,114548,40888,561391
2015-01-13,73786,134065,47796,32446,118055,116535,40986,563669
2015-01-12,73190,134685,47821,32446,117867,116726,41085,563820
2015-01-09,71073,134561,47878,32581,118136,118944,41025,564198
2015-01-08,68925,133910,47866,32577,118004,119755,41028,562065
2015-01-07,68099,133151,47857,32583,117937,121428,41126,562181
2015-01-06,67148,133010,47870,32601,117915,121257,41129,560930
2015-01-05,67176,133685,47883,32621,117840,120862,41179,561246
2015-01-02,66487,136717,47924,32705,117829,120549,41098,563309
2014-12-30,64854,138093,47941,32789,117792,121299,41096,563864
2014-12-29,67537,138146,47862,32681,118224,116677,40944,562071
2014-12-24,68095,137879,47857,32720,118158,114301,40856,559866
2014-12-23,70298,137507,47798,32686,118249,110670,40862,558070
2014-12-22,70093,136839,47709,32696,118019,111477,40911,557744
2014-12-19,69199,135703,47620,32700,117846,109443,40828,553339
2014-12-18,66196,133840,47465,32660,117660,108896,40904,547621
2014-12-17,66076,132714,47374,32635,117398,107584,40858,544639
2014-12-16,67776,132153,47318,32586,117212,106713,40812,544570
2014-12-15,67544,132414,47302,32584,116931,106834,40902,544511
2014-12-12,66726,132042,47277,32625,116706,106478,40523,542377
2014-12-11,66471,131120,47275,32615,116531,108312,40414,542738
2014-12-10,66675,130805,47269,32625,116460,108424,40512,542770
2014-12-09,65462,131427,47310,32731,116324,109037,40500,542791
2014-12-05,64395,131380,47287,32728,116407,109909,40376,542482
2014-12-04,65443,130284,47264,32812,116581,110260,40370,543014
2014-12-03,65016,129755,47229,32787,116526,111959,40280,543552
2014-12-02,65004,129499,47209,32777,116458,111952,39990,542889
2014-12-01,65117,130754,47187,32763,116440,110154,39880,542295
2014-11-28,63839,131156,47212,32852,116458,112120,39576,543213
2014-11-27,64863,129721,47169,32806,116474,110522,39403,540958
2014-11-26,65706,129299,47143,32788,116356,107663,39348,538303
2014-11-25,65269,130049,47120,32776,116086,106155,39340,536795
2014-11-21,64434,129926,47124,32772,115855,105200,39188,534499
2014-11-20,65512,129537,47140,32800,115514,104811,39322,534636
2014-11-19,65218,129023,47122,32788,115270,104164,39440,533025
2014-11-18,66147,128847,47126,32746,114947,103378,39354,532545
2014-11-17,65740,129728,47105,32765,114622,102447,39486,531893
2014-11-14,65114,129302,47099,32796,114365,102245,39479,530400
2014-11-13,66986,128016,47063,32790,114054,102336,39375,530620
2014-11-12,66377,128046,47068,32779,113996,102407,39274,529947
2014-11-11,66011,128254,47040,32765,113913,103578,38876,530437
2014-11-10,64718,128146,47045,32753,113677,103011,38826,528176
2014-11-07,63673,128387,47072,32896,113993,105001,38951,529973
2014-11-05,63954,127757,47077,32863,113965,105932,39014,530562
2014-11-04,63792,126826,47061,32917,113927,107235,39138,530896
2014-11-03,64600,127453,47061,32897,113672,105453,39252,530388
2014-10-31,62065,128250,47077,32868,113575,107069,39243,530147
2014-10-30,62932,127521,46970,32839,113918,106179,39064,529423
2014-10-29,64547,126338,46953,32852,113723,105252,38222,527887
2014-10-28,65616,126155,46940,32800,113634,103539,38503,527187
2014-10-27,66504,126592,46941,32677,113462,101604,38548,526328
2014-10-24,67327,126718,46929,32662,113400,100757,38146,525939
2014-10-23,67646,125949,46908,32595,113127,99730,37927,523882
2014-10-22,68692,125475,46859,32558,112827,98822,37940,523173
2014-10-21,68287,125858,46855,32521,112686,97855,37982,522044
2014-10-20,68221,126254,46881,32549,112386,96655,38089,521035
2014-10-17,67780,126126,46879,32549,111991,96571,38119,520015
2014-10-16,69176,124443,46875,32517,111714,97937,37719,520381
2014-10-15,70093,124667,46865,32485,111435,98082,37736,521363
2014-10-14,70146,125604,46886,32478,111230,97710,37867,521921
2014-10-10,68134,125749,46936,32523,111080,98827,37731,520980
2014-10-09,67996,124855,46897,32576,110931,99407,37771,520433
2014-10-08,67533,124275,46889,32538,110929,100792,37821,520777
2014-10-07,68624,123941,46865,32516,110762,101192,37897,521797
2014-10-06,69261,123794,46878,32528,110652,100148,37922,521183
2014-10-03,68700,123428,46878,32595,110817,100826,37792,521036
2014-10-02,68272,122498,46860,32546,110651,100727,37866,519420
2014-10-01,69257,122412,46825,32407,110446,99450,37848,518645
2014-09-30,66819,123555,46809,32503,110430,100162,37848,518126
2014-09-29,67771,122195,46708,32295,110540,97711,37652,514872
2014-09-26,68213,121511,46675,32268,110455,96243,37372,512737
2014-09-25,68837,120580,46660,32205,110325,95444,37307,511358
2014-09-24,69773,119558,46642,32144,110058,94420,37328,509923
2014-09-23,70091,118905,46641,32094,109797,93514,37403,508445
2014-09-22,70200,119121,46617,32107,109512,92146,37433,507136
2014-09-19,69716,118976,46640,32092,109343,91265,37492,505524
2014-09-18,70178,118023,46611,32060,109100,90616,37602,504190
2014-09-17,70714,117537,46558,32019,108739,89907,37626,503100
2014-09-16,71928,117513,46538,31975,108504,89484,37545,503487
2014-09-15,71976,118223,46530,31953,108195,88780,37562,503219
2014-09-12,71513,118246,46549,32117,108037,88616,37596,502674
2014-09-11,72242,117656,46537,32112,107888,89446,37503,503384
2014-09-10,71166,117424,46436,32078,107656,90831,37407,502998
2014-09-09,70620,117045,46447,32150,107497,91835,37575,503169
2014-09-08,69941,117129,46458,32124,107321,92491,37529,502993
2014-09-05,69506,117177,46469,32135,107342,93263,37589,503481
2014-09-04,70567,116387,46454,32207,107245,93619,37715,504194
2014-09-03,70032,115938,46415,32167,107177,93874,37666,503269
2014-09-02,70333,115507,46405,32159,107069,95223,37912,504608
2014-09-01,70989,116622,46412,32096,106873,93886,37956,504834
2014-08-29,69185,116778,46381,32020,106994,95423,37870,504651
2014-08-28,70672,114894,46388,32014,107123,93968,37931,502990
2014-08-27,70488,114908,46399,32005,107149,93309,37737,501995
2014-08-26,71495,114209,46330,31948,107272,91834,37737,500825
2014-08-25,72027,114323,46297,31923,107135,90327,37843,499875
2014-08-22,71478,113942,46283,31906,106965,89728,37775,498077
2014-08-21,71270,113130,46268,31880,106685,88604,37726,495563
2014-08-20,71836,113093,46254,31891,106432,88360,37812,495678
2014-08-19,71767,113728,46267,31887,106172,87191,37917,494929
2014-08-15,71794,113906,46279,31899,105960,86970,37901,494709
2014-08-14,72334,113165,46215,31832,105779,87776,37890,494991
2014-08-13,72324,112710,46185,31835,105545,88483,37897,494979
2014-08-12,72645,112676,46177,31806,105326,90104,37873,496607
2014-08-11,71469,113097,46207,31789,105049,89880,37999,495490
2014-08-08,69946,112938,46234,31899,105105,91482,38004,495608
2014-08-07,70809,112032,46214,31842,104974,91898,37906,495675
2014-08-06,70404,112017,46194,31827,105092,93035,38007,496576
2014-08-05,69691,111721,46184,31858,105052,93738,38006,496250
2014-08-04,69290,111480,46180,31896,105010,92797,38124,494777
2014-08-01,69063,111749,46169,31913,105060,93552,37993,495499
2014-07-31,67599,112313,46178,31924,105044,93734,38109,494901
2014-07-30,68208,111844,46162,31797,105175,92649,37994,493829
2014-07-29,68320,111610,46128,31789,105068,91520,38025,492460
2014-07-28,68553,111765,46137,31686,105011,89858,37848,490858
2014-07-25,68555,112119,46146,31678,104901,88859,37607,489865
2014-07-24,70239,111548,46137,31653,104681,88170,37643,490071
2014-07-23,70784,111100,46032,31610,104501,87390,37656,489073
2014-07-22,72177,110919,46017,31597,104329,86510,37470,489019
2014-07-21,71317,111436,46026,31611,104124,85561,37577,487652
2014-07-18,70206,111403,46042,31627,104004,84880,37584,485746
2014-07-17,71084,110751,46034,31612,103806,84554,37417,485258
2014-07-16,71583,110587,45983,31609,103640,84366,37442,485210
2014-07-15,72903,110826,45979,31609,103715,84083,37451,486566
2014-07-14,73070,111061,45962,31626,103595,83485,37547,486346
2014-07-11,71504,111331,45985,31674,103532,84320,37477,485823
2014-07-10,70198,111243,46014,31672,103453,86397,37462,486439
2014-07-08,69262,111039,46038,31772,103599,88197,37455,487362
2014-07-07,68031,111344,46033,31768,103651,88437,37362,486626
2014-07-04,67177,111004,46061,31887,103837,89621,37250,486837
2014-07-03,66406,110203,46037,31861,103931,90394,37359,486191
2014-07-02,66064,109791,46016,31854,103968,92498,37383,487574
2014-07-01,67298,109992,45976,31877,104043,92474,37317,488977
2014-06-30,63965,111720,45976,31959,104012,96293,37388,491313
2014-06-27,64961,110445,45901,31917,104600,94636,37102,489562
2014-06-26,65875,108914,45808,31887,104499,94036,36722,487741
2014-06-25,67039,108400,45770,31822,104468,93562,36626,487687
2014-06-24,67692,108526,45711,31788,104340,92190,36526,486773
2014-06-23,67307,109427,45716,31851,104169,90318,36520,485308
2014-06-19,66411,109081,45741,31876,104000,89977,36506,483592
2014-06-18,66472,108273,45286,31861,103965,89200,36496,481553
2014-06-17,67110,107974,45278,31857,103928,88772,36469,481388
2014-06-16,67694,108788,45252,31850,103813,87746,36534,481677
2014-06-13,66884,108567,45261,31889,103653,87655,36485,480394
2014-06-12,66212,107916,45241,31872,103652,88361,36484,479738
2014-06-11,66079,107528,45232,31855,103522,89824,36501,480541
2014-06-10,65396,107756,45262,31856,103441,90647,36582,480940
2014-06-09,64124,108092,45286,31963,103441,90471,36690,480067
2014-06-06,63297,107800,45300,31977,103461,92551,36557,480943
2014-06-05,63934,106875,45267,31968,103386,92333,36554,480317
2014-06-04,63587,106220,45262,32032,103506,93442,36591,480640
2014-06-03,63412,106107,45259,31997,103505,93763,36540,480583
2014-06-02,63733,107539,45242,32006,103456,93068,36569,481613
2014-05-30,60947,108767,45267,32000,103407,94282,36531,481201
2014-05-29,62464,107447,45182,31969,103558,93202,36224,480046
2014-05-28,62776,107530,45180,31936,103636,92148,35990,479196
2014-05-27,63784,107379,45154,31926,103540,91101,35998,478882
2014-05-26,64354,107913,45069,31907,103423,89336,35992,477994
2014-05-23,64587,107713,45079,31896,103635,89344,35829,478083
2014-05-22,65112,107270,45036,31869,103440,89003,35895,477625
2014-05-21,65520,107304,45002,31841,103201,88419,35990,477277
2014-05-20,65752,107430,44969,31881,103111,86976,35809,475928
2014-05-19,66072,107220,44978,31880,102910,85821,35801,474682
2014-05-16,66981,107127,44980,31874,102725,86503,35880,476070
2014-05-15,67400,107034,44945,31876,102483,87309,35942,476989
2014-05-14,67121,107022,44931,31873,102413,88863,36022,478245
2014-05-13,67958,106830,44916,31883,102324,89993,35863,479767
2014-05-12,66783,107469,44948,31873,102254,89930,35937,479194
2014-05-09,64394,107456,44988,31957,102372,91383,36197,478747
2014-05-08,63410,106692,44969,31955,102232,92804,36157,478219
2014-05-07,61875,106195,44925,31956,102225,92849,36214,476239
2014-05-06,61967,106179,44905,31982,102206,93321,36026,476586
2014-05-05,62323,107204,44927,32016,102147,92525,36139,477281
2014-04-30,60507,108726,44950,32191,102001,93368,36185,477928
2014-04-29,60805,108080,44925,32196,102688,91337,35784,475815
2014-04-28,61355,108299,44926,32185,102712,90063,35712,475252
2014-04-25,61866,108480,44940,32195,102633,89786,35650,475550
2014-04-24,62772,108188,44583,32173,102477,89312,35660,475165
2014-04-23,62562,107872,44571,32155,102568,87775,35497,473000
2014-04-22,63703,107990,44556,32134,102387,86919,35475,473164
2014-04-21,62154,109413,44583,32200,102147,85759,35560,471816
2014-04-16,61908,109529,44636,32241,102012,84886,35379,470591
2014-04-15,63869,109791,44620,32236,101796,85160,35416,472888
2014-04-14,62729,110099,44636,32243,101822,84629,35463,471621
2014-04-11,63175,109954,44653,32267,101609,85519,35427,472604
2014-04-10,62900,109634,44655,32165,101461,87215,35454,473484
2014-04-09,62629,109783,44669,32271,101542,88212,35508,474614
2014-04-08,62046,109270,44677,32255,101382,88955,35525,474110
2014-04-07,61491,109654,44685,32276,101337,89516,35463,474422
2014-04-04,60297,109590,44700,32385,101524,90603,35543,474642
2014-04-03,59825,109266,44700,32349,101475,90698,35591,473904
2014-04-01,60871,109608,44701,32373,101461,91275,35752,476041
2014-03-31,59287,111133,44697,32423,101553,92664,35866,477623
2014-03-28,60842,110351,44641,32343,101957,90317,35691,476142
2014-03-27,61514,109621,44627,32318,101953,89697,35635,475365
2014-03-26,62767,109483,44621,32316,101823,88358,35483,474851
2014-03-25,62818,110234,44598,32323,101748,86645,35605,473971
2014-03-21,62171,110369,44599,32336,101811,86287,35431,473004
2014-03-20,62702,110076,44578,32361,101666,86016,35518,472917
2014-03-19,62408,109709,44530,32357,101502,85096,35669,471271
2014-03-18,63443,109809,44510,32350,101405,84907,35699,472123
2014-03-17,64317,110393,44520,32346,101248,84505,35763,473092
2014-03-14,64827,110447,44524,32375,101130,86158,35780,475241
2014-03-13,65681,109700,44519,32400,100996,87047,35814,476157
2014-03-12,65102,109484,44512,32391,100874,87601,35722,475686
2014-03-11,65263,109389,44514,32415,100846,88788,35709,476924
2014-03-10,62420,110115,44549,32433,100667,88941,35752,474877
2014-03-07,61830,110275,44560,32547,100929,90209,35640,475990
2014-03-06,61741,110078,44530,32554,101013,90179,35656,475751
2014-03-05,62237,111363,44511,32539,101021,89495,35703,476869
2014-02-28,58984,113061,44541,32748,101192,91281,35619,477426
2014-02-27,60094,111985,44476,32703,101459,89562,35568,475847
2014-02-26,60974,111784,44426,32622,101471,89123,35580,475980
2014-02-25,61495,111750,44385,32593,101399,87793,35188,474603
2014-02-24,61579,112097,44361,32550,101313,86585,35228,473713
2014-02-21,61124,112355,44381,32528,101409,86453,35096,473346
2014-02-20,61267,112334,44354,32535,101249,86097,35133,472969
2014-02-19,61143,112076,44313,32511,101250,85627,35228,472148
2014-02-18,62220,112114,44312,32479,101118,85445,35268,472956
2014-02-17,62626,112893,44304,32448,101214,84803,35273,473561
2014-02-14,61342,113175,44305,32446,101113,85250,35471,473102
2014-02-13,61747,112838,44259,32423,101030,86153,35422,473872
2014-02-12,61769,112761,44254,32373,100888,87763,35554,475362
2014-02-11,61316,112981,44227,32333,100770,88513,35530,475670
2014-02-10,60760,113626,44242,32290,100699,88532,35574,475723
2014-02-07,60053,113700,44261,32353,100980,89782,35529,476658
2014-02-06,59717,113145,44226,32280,100908,89977,35663,475916
2014-02-05,59683,112764,44218,32221,100891,90992,35746,476515
2014-02-04,59277,112577,44217,32277,100886,91739,35870,476843
2014-02-03,59963,113170,44211,32204,100801,91499,35876,477724
2014-01-31,57714,114211,44199,32165,100902,91805,35921,476917
2014-01-30,58764,113602,44176,32104,101163,90701,35399,475909
2014-01-29,58608,113348,44167,32017,101077,89668,35452,474337
2014-01-28,59196,113440,44176,31975,101012,88560,35421,473780
2014-01-27,59983,113924,44179,31950,100893,87501,35434,473864
2014-01-24,60256,114080,44181,31919,100677,86468,35375,472956
2014-01-23,60296,113212,44164,31890,100440,85774,35513,471289
2014-01-22,59678,112722,44135,31841,100249,85085,35572,469282
2014-01-21,59827,112555,44116,31794,100027,84528,35742,468589
2014-01-20,60075,113125,44078,31787,99859,83656,35870,468450
2014-01-17,59639,113223,44070,31766,99674,83106,35964,467442
2014-01-16,60314,112770,44031,31708,99476,82497,36169,466965
2014-01-15,60620,112903,44024,31657,99250,82588,36095,467137
2014-01-14,60243,112924,44027,31636,99101,82426,36195,466552
2014-01-13,60545,113202,43988,31618,98953,82055,36159,466520
2014-01-10,58882,113474,44006,31617,99072,82845,36200,466096
2014-01-09,58390,112744,44004,31668,99034,84808,36295,466943
2014-01-08,56966,112241,43981,31640,98911,85842,36406,465987
2014-01-07,56660,112157,43975,31620,98834,86213,36494,465953
2014-01-06,55380,112513,43951,31571,98733,86884,36525,465557
2014-01-03,55117,113345,43944,31677,98789,87220,36663,466755
2014-01-02,53930,115725,43921,31652,98811,86635,36679,467353
2013-12-30,52729,116888,43928,31709,98823,88327,36662,469066
2013-12-27,55037,115803,43759,31580,99188,84435,36589,466391
2013-12-26,55937,115070,43644,31529,99148,83140,36274,464742
2013-12-23,56017,115360,43571,31487,99153,80916,36481,462985
2013-12-20,57252,114278,43358,31460,98962,80258,35928,461496
2013-12-19,57527,112429,43171,31380,98804,79346,35506,458163
2013-12-18,56964,111226,43036,31298,98716,78463,35241,454944
2013-12-17,57781,110633,42952,31234,98546,78062,35309,454517
2013-12-16,57550,110751,42910,31205,98336,77124,35032,452908
2013-12-13,57796,110399,42854,31193,98383,77485,34952,453062
2013-12-12,57877,109423,42769,31201,98169,78042,34875,452356
2013-12-11,57867,108615,42707,31142,98006,79467,34803,452607
2013-12-10,58029,108267,42705,31091,97929,79677,34774,452472
2013-12-09,57189,108345,42687,31130,97929,79539,34849,451668
2013-12-06,56696,108004,42628,31104,97975,80030,34747,451184
2013-12-05,57373,107218,42539,31087,97788,80540,34638,451183
2013-12-04,57472,106479,42513,31126,97743,81006,34539,450878
2013-12-03,57295,106141,42483,31086,97661,80516,34546,449728
2013-12-02,57199,107204,42453,31058,97575,80134,34530,450153
2013-11-29,56218,107517,42390,30965,97531,81125,34383,450129
2013-11-28,57074,105994,42345,31023,98099,79526,34236,448297
2013-11-27,57929,105341,42248,30948,97841,78014,33965,446286
2013-11-26,58039,105903,42192,30906,97763,76789,33914,445506
2013-11-22,57475,105833,42156,30912,97663,76191,33836,444066
2013-11-21,57680,105329,42097,30879,97293,75323,33748,442349
2013-11-20,57482,105116,42056,30838,97052,74714,33737,440995
2013-11-19,57892,104773,42013,30778,96780,74510,33893,440639
2013-11-18,57997,105011,42017,30757,96544,73752,33964,440042
2013-11-15,57860,105250,41946,30717,96379,74254,33756,440162
2013-11-14,58598,104656,41907,30646,96413,74920,33804,440944
2013-11-13,59427,104141,41880,30599,96211,76212,33676,442146
2013-11-12,58671,104061,41848,30550,95998,76423,33610,441161
2013-11-11,58378,104358,41849,30500,95898,76127,33647,440757
2013-11-08,57885,104403,41836,30553,95885,76761,33585,440908
2013-11-07,57703,104027,41809,30516,95699,77629,33610,440993
2013-11-05,57861,103399,41761,30512,95525,78211,33520,440789
2013-11-04,56989,103337,41755,30488,95497,77957,33471,439494
2013-11-01,57408,103403,41729,30446,95495,77954,33455,439890
2013-10-31,55521,103954,41615,30387,95572,78310,33340,438699
2013-10-30,57332,103264,41565,30241,95614,76922,33229,438167
2013-10-29,57770,102889,41532,30122,95450,75887,33021,436671
2013-10-28,57943,103167,41485,30029,95366,74753,33043,435786
2013-10-25,58058,103264,41461,29992,95231,74343,32986,435335
2013-10-24,59185,102890,41412,29920,95016,73658,33007,435088
2013-10-23,59609,102495,41391,29856,94966,72385,32988,433690
2013-10-22,60517,102271,41337,29786,94741,71459,33090,433201
2013-10-21,60510,102572,41292,29767,94514,70462,33173,432290
2013-10-18,60063,102592,41324,29704,94318,69567,33133,430701
2013-10-17,60416,101799,41249,29638,94095,69034,33008,429239
2013-10-16,61364,101638,41163,29601,93874,68742,33091,429473
2013-10-15,60188,102614,41136,29561,93676,67864,33128,428167
2013-10-11,60681,102612,41148,29558,93621,68142,33111,428873
2013-10-10,60353,102216,41126,29509,93404,68912,33048,428568
2013-10-09,59584,101751,41114,29552,93428,70180,33070,428679
2013-10-08,59718,101541,41107,29438,93271,70728,33124,428927
2013-10-07,59856,101624,41095,29384,93152,70971,33158,429240
2013-10-04,59894,101489,41038,29430,93344,71315,32948,429458
2013-10-03,60081,100695,41021,29368,93316,71640,32910,429031
2013-10-02,59411,100208,40997,29293,93230,72363,32845,428347
2013-10-01,59714,100392,40989,29227,93138,72554,32856,428870
2013-09-30,58173,101718,40957,29230,93148,73425,32620,429271
2013-09-27,58966,100747,40982,29123,92603,71839,33266,427526
2013-09-26,59273,99767,40885,28989,92400,71299,32936,425549
2013-09-25,59838,99260,40850,28955,92270,70515,32911,424599
2013-09-24,60256,98909,40827,28900,92106,69386,32928,423312
2013-09-23,60302,98910,40797,28872,91883,68306,32943,422013
2013-09-20,60038,99103,40811,28867,91848,67969,32995,421631
2013-09-19,60206,98405,40747,28816,91631,67483,32990,420278
2013-09-18,60244,97957,40698,28772,91402,67042,33026,419141
2013-09-17,60703,97792,40679,28708,91188,66906,33104,419080
2013-09-16,60705,98419,40651,28650,90948,66284,33151,418808
2013-09-13,60431,98341,40618,28612,90805,66409,33081,418297
2013-09-12,60353,97904,40565,28559,90550,66953,33041,417925
2013-09-11,60071,97362,40557,28524,90447,68309,33043,418313
2013-09-10,59646,97181,40563,28464,90237,68692,32926,417709
2013-09-09,58773,97137,40560,28528,90198,69208,33046,417450
2013-09-06,57418,96967,40561,28504,90197,69401,32907,415955
2013-09-05,58585,96433,40517,28451,90044,69907,32844,416781
2013-09-04,57262,95695,40500,28518,90018,70734,32809,415536
2013-09-03,57790,95317,40458,28459,89911,71113,32823,415871
2013-09-02,58036,95875,40443,28410,89799,70811,32863,416237
2013-08-30,55782,96669,40406,28407,89708,71059,32724,414755
2013-08-29,56925,95461,40366,28286,89967,70223,32639,413867
2013-08-28,57330,94866,40338,28207,89989,69502,32413,412645
2013-08-27,57753,94733,40328,28157,89852,68971,32364,412158
2013-08-26,58041,94992,40302,28111,89694,67605,32321,411066
2013-08-23,57670,94907,40276,28087,89517,67103,32171,409731
2013-08-22,58255,94290,40227,28002,89317,66745,32178,409014
2013-08-21,59111,93896,40194,27944,89091,66091,32245,408572
2013-08-20,58056,94614,40166,27934,88926,65185,32369,407250
2013-08-16,58266,94654,40111,27902,88742,65275,32362,407312
2013-08-15,58345,94522,40083,27837,88572,65694,32431,407484
2013-08-14,57883,94132,40055,27796,88416,66868,32458,407608
2013-08-13,58747,94085,39905,27768,88224,67158,32504,408391
2013-08-12,58213,94213,39910,27724,88047,67128,32401,407636
2013-08-09,56972,94046,39939,27782,88078,67396,32395,406608
2013-08-08,56173,93399,39905,27725,87872,68181,32469,405724
2013-08-07,55960,92988,39832,27662,87730,69005,32500,405677
2013-08-06,55903,92776,39826,27638,87839,69415,32527,405924
2013-08-05,55016,92883,39821,27603,87770,69211,32560,404864
2013-08-02,54140,92657,39806,27646,87791,69233,32551,403824
2013-08-01,55127,92357,39760,27707,87689,68930,32392,403962
2013-07-31,53695,92822,39747,27599,87598,68803,32375,402639
2013-07-30,54680,92500,39702,27594,87937,67906,32454,402773
2013-07-29,54793,92625,39687,27527,87804,66940,32442,401818
2013-07-26,54859,92642,39681,27476,87707,66085,32280,400730
2013-07-25,55281,92446,39623,27408,87610,65537,32443,400348
2013-07-24,55611,92193,39597,27380,87440,64834,32416,399471
2013-07-23,56033,92081,39559,27322,87281,64450,32523,399249
2013-07-22,56252,92587,39552,27297,87118,63593,32520,398919
2013-07-19,55873,92597,39563,27297,86982,62980,32580,397872
2013-07-18,56503,91951,39549,27260,86780,62563,32823,397429
2013-07-17,56445,91702,39470,27203,86583,62142,32869,396414
2013-07-16,57297,91650,39449,27132,86437,62001,32926,396892
2013-07-15,57271,92151,39418,27082,86270,61487,32957,396636
2013-07-12,56218,92056,39415,27097,86176,61931,32885,395778
2013-07-11,55868,91396,39356,27102,86023,63335,32820,395900
2013-07-10,55284,91566,39332,27059,85876,63802,32868,395787
2013-07-08,54602,91693,39337,27139,85996,64272,32838,395877
2013-07-05,53713,91695,39334,27120,86039,64849,32842,395592
2013-07-04,54019,91023,39280,27114,85979,65308,32920,395643
2013-07-03,53039,90486,39225,27074,85949,65591,32752,394116
2013-07-02,53274,90471,39160,27049,85906,65672,32805,394337
2013-07-01,53475,91410,39091,27003,85852,65818,32886,395535
2013-06-28,50758,91614,39098,26988,86231,68094,32552,395335
2013-06-27,52006,89537,38928,26856,86352,67347,32412,393438
2013-06-26,52058,87932,38831,26653,86269,66582,32016,390341
2013-06-25,52824,87786,38743,26585,86140,65986,32058,390122
2013-06-24,52533,88344,38708,26531,86092,64619,31783,388610
2013-06-19,52429,87989,38654,26500,86221,64014,31437,387244
2013-06-18,53382,87253,38545,26443,86063,63001,31158,385845
2013-06-17,53464,87657,38460,26393,85873,62664,30974,385485
2013-06-14,52780,87660,38429,26396,85758,62703,30994,384720
2013-06-13,53049,86857,38370,26301,85585,63145,30960,384267
2013-06-12,52809,86505,38308,26291,85428,64297,30869,384507
2013-06-11,52654,86168,38209,26205,85281,64274,30755,383546
2013-06-10,52100,86530,38228,26199,85152,64846,30685,383740
2013-06-07,51504,86440,38203,26234,85312,65145,30630,383468
2013-06-06,51055,85886,38154,26191,85216,65292,30616,382410
2013-06-05,50933,85531,38103,26123,85190,66015,30703,382598
2013-06-04,50558,85162,38093,26145,85152,66533,30568,382211
2013-06-03,51156,85412,38056,26094,85076,66275,30580,382649
2013-05-31,49715,86427,38025,26019,85087,66306,30540,382119
2013-05-30,50457,85823,37941,25901,85265,65917,30433,381737
2013-05-29,50715,85282,37882,25762,85299,65218,30368,380526
2013-05-28,51472,85023,37851,25673,85124,64442,30380,379965
2013-05-27,51953,85410,37802,25602,84998,63414,30306,379485
2013-05-24,51694,85265,37786,25574,84926,62596,30309,378150
2013-05-23,52437,84674,37755,25479,84762,62177,30256,377540
2013-05-22,52780,84332,37707,25431,84588,61837,30232,376907
2013-05-21,53091,84197,37649,25371,84365,61614,30547,376834
2013-05-20,52969,84982,37650,25319,84150,61009,30219,376298
2013-05-17,53068,84997,37624,25315,83963,61047,30023,376037
2013-05-16,53958,84361,37558,25253,83743,61708,29907,376488
2013-05-15,54042,84360,37491,25208,83531,62961,29874,377467
2013-05-14,54027,84041,37450,25181,83371,63263,29832,377165
2013-05-13,54020,84309,37433,25145,83199,62967,29750,376823
2013-05-10,52972,84337,37443,25107,83099,63243,29755,375956
2013-05-09,52825,83701,37414,25125,83081,63554,29816,375516
2013-05-08,52511,83192,37400,25075,82920,64715,29819,375632
2013-05-07,52798,83017,37393,25043,82834,65028,29571,375684
2013-05-06,51908,83192,37344,25012,82771,64798,29508,374533
2013-05-03,51974,82852,37327,25042,82777,64689,29340,374001
2013-05-02,52471,82544,37322,25003,82708,64530,29377,373955
2013-04-30,51164,83524,37303,24910,82811,64542,29071,373325
2013-04-29,51961,83187,37188,24851,82905,62846,28816,371754
2013-04-26,51892,82864,37135,24729,83167,62356,28737,370880
2013-04-25,52239,82333,37100,24635,83030,61905,28631,369873
2013-04-24,52524,81835,37079,24582,82905,61494,28595,369014
2013-04-23,53222,81365,37060,24527,82685,61101,28540,368500
2013-04-22,53103,81912,37030,24507,82472,60368,28532,367924
2013-04-19,52517,82105,36998,24475,82337,60008,28474,366914
2013-04-18,52489,81673,36970,24422,82094,59891,28474,366013
2013-04-17,52998,81164,36943,24396,81855,59785,28505,365646
2013-04-16,53420,81092,36921,24339,81647,59710,28524,365653
2013-04-15,53526,81698,36906,24302,81412,59399,28540,365783
2013-04-12,52780,81868,36893,24273,81255,59699,28372,365140
2013-04-11,52466,81313,36861,24215,81115,60683,28284,364937
2013-04-10,51791,81103,36866,24189,80931,61252,28280,364412
2013-04-09,51451,81033,36863,24214,80902,61986,28241,364690
2013-04-08,50882,81185,36826,24182,80771,62473,28329,364648
2013-04-05,50714,81105,36816,24175,80779,63685,28162,365436
2013-04-04,51416,80926,36804,24194,80704,63463,28178,365685
2013-04-03,50211,82655,36806,24183,80630,62129,27859,364473
2013-03-27,50216,82901,36822,24187,80595,63373,27890,365984
2013-03-26,51335,81975,36762,24130,80843,61604,27698,364347
2013-03-25,51134,81440,36685,23995,80654,61173,27616,362697
2013-03-22,50916,81212,36664,23962,80475,60158,27183,360570
2013-03-21,51151,80568,36629,23901,80437,59744,27109,359539
2013-03-20,51097,80381,36599,23855,80246,59490,27026,358694
2013-03-19,51351,80028,36593,23821,80287,59178,27054,358312
2013-03-18,51647,80358,36583,23784,80235,58757,27096,358460
2013-03-15,51524,80666,36558,23767,79869,58876,27075,358335
2013-03-14,51522,80092,36519,23717,79690,59379,27069,357988
2013-03-13,52028,79810,36489,23661,79479,60414,27136,359017
2013-03-12,51884,79644,36479,23607,79271,60712,27145,358742
2013-03-11,51180,80004,36414,23569,79091,60569,27117,357944
2013-03-08,50848,79981,36436,23608,79165,61250,26985,358273
2013-03-07,51198,79390,36379,23564,79020,61518,27023,358092
2013-03-06,50680,79086,36360,23515,78953,62328,27069,357991
2013-03-05,50393,78895,36351,23486,78908,62584,27379,357996
2013-03-04,50275,78993,36330,23516,78860,62344,27330,357648
2013-03-01,50704,78897,36325,23523,78867,62255,27287,357858
2013-02-28,49283,79568,36283,23491,78802,62501,27268,357196
2013-02-27,50790,78828,36211,23453,78999,61563,26783,356627
2013-02-26,51189,78522,36180,23407,78919,61139,26721,356077
2013-02-25,51577,78501,36133,23346,78775,59802,26766,354900
2013-02-22,51796,78462,36114,23316,78614,59460,26792,354554
2013-02-21,51691,78386,36090,23279,78428,59124,26849,353847
2013-02-19,51922,78213,36084,23270,78207,58932,26822,353450
2013-02-18,52286,78450,36056,23242,78000,58425,26919,353378
2013-02-15,51976,78753,36044,23215,77803,59455,26932,354178
2013-02-14,51734,78534,35969,23202,77744,59822,27028,354033
2013-02-13,50443,79458,35978,23192,77558,59763,27105,353497
2013-02-08,49567,79526,36000,23242,77645,61056,27014,354050
2013-02-07,49599,78859,35956,23210,77484,61313,27126,353547
2013-02-06,49233,78505,35928,23216,77370,61821,27187,353260
2013-02-05,49249,78354,35901,23173,77273,62189,27254,353393
2013-02-04,49095,78476,35899,23183,77158,62336,27322,353469
2013-02-01,48966,79229,35888,23110,77136,61986,27252,353567
2013-01-30,48905,79409,35869,23057,77049,61638,27287,353214
2013-01-29,48765,78997,35734,23021,77164,60973,27044,351698
2013-01-28,48775,79187,35723,22951,77098,60169,27082,350985
2013-01-25,48614,79264,35730,22920,77007,59767,27078,350380
2013-01-24,49277,78881,35707,22829,76878,59104,27034,349710
2013-01-23,49632,78696,35690,22821,76698,58775,27078,349390
2013-01-22,49802,78612,35666,22727,76536,58311,27168,348822
2013-01-21,49482,79287,35643,22719,76083,57762,27240,348216
2013-01-18,48695,79414,35645,22723,75914,57292,27407,347090
2013-01-17,49027,79171,35576,22683,75728,57210,27499,346894
2013-01-16,49540,79054,35563,22637,75556,57071,27578,346999
2013-01-15,49496,79337,35556,22598,75384,57046,27649,347066
2013-01-14,49650,79544,35497,22554,75226,56644,27621,346736
2013-01-11,49811,79571,35482,22530,75203,57905,27672,348174
2013-01-10,48975,79394,35476,22500,75046,58472,27722,347585
2013-01-09,48420,79081,35467,22535,75089,59117,27751,347460
2013-01-08,47957,78820,35459,22502,74994,59562,27839,347133
2013-01-07,47823,79131,35468,22451,75144,59764,28027,347808
2013-01-04,46703,79181,35468,22483,75203,60403,28120,347561
2013-01-03,47059,79344,35393,22475,75147,60258,28193,347869
2013-01-02,45688,81552,35372,22450,75169,60023,28067,348321
2012-12-31,45159,81894,35376,22424,75154,61020,28121,349148
2012-12-28,45860,81345,35317,22503,75755,59426,28178,348384
2012-12-27,48498,79412,35021,22443,75671,58055,28090,347190
2012-12-26,48377,79288,34954,22403,75675,56726,28086,345509
2012-12-21,48115,78749,34888,22364,75714,56088,28030,343948
2012-12-20,48423,77779,34739,22314,75566,55579,27885,342285
2012-12-19,48134,76691,34589,22280,75427,55031,27819,339971
2012-12-18,48193,76073,34543,22187,75290,54606,27788,338680
2012-12-17,48281,76015,34481,22126,75100,53924,27604,337531
2012-12-14,47335,75378,34377,22084,74987,54067,27491,335719
2012-12-13,48258,74676,34257,22034,74875,54390,27373,335863
2012-12-12,47744,74211,34157,21970,74696,55249,27285,335312
2012-12-11,48118,73521,34038,21923,74551,55619,27060,334830
2012-12-10,47544,73542,34009,21881,74416,55879,27143,334414
2012-12-07,46894,73405,33999,21901,74575,56095,27098,333967
2012-12-06,47172,72696,33961,21860,74485,56458,27078,333710
2012-12-05,47238,72325,33916,21820,74443,56755,27029,333526
2012-12-04,46908,71805,33836,21844,74385,56991,27093,332862
2012-12-03,46721,71930,33799,21818,74291,56697,27134,332390
2012-11-30,45753,72637,33760,21793,74291,57368,26910,332512
2012-11-29,46856,71608,33662,21670,74348,55871,26852,330867
2012-11-28,47319,71266,33616,21544,74187,55108,26814,329854
2012-11-27,47021,71756,33568,21458,74058,54199,26685,328745
2012-11-23,46699,71565,33546,21435,74002,54015,26564,327826
2012-11-22,47649,70939,33469,21362,73783,53487,26588,327277
2012-11-21,47141,70518,33416,21291,73592,52945,26608,325511
2012-11-20,47605,70427,33384,21255,73402,52783,26613,325469
2012-11-19,46565,71014,33391,21244,73479,52430,26722,324845
2012-11-16,46484,70912,33363,21196,73386,52522,26580,324443
2012-11-15,46503,70630,33318,21123,73178,52835,26554,324141
2012-11-14,46491,70229,33288,21073,73015,53849,26557,324502
2012-11-13,47043,70017,33225,21012,72823,54004,26534,324658
2012-11-12,46716,70308,33214,20987,72674,53913,26512,324324
2012-11-09,45911,70075,33180,21030,72844,54063,26431,323534
2012-11-08,46070,69448,33107,20999,72815,54894,26434,323767
2012-11-07,46220,69399,33057,20943,72710,54633,26451,323413
2012-11-05,45364,69420,32986,20910,72631,55276,26433,323020
2012-11-02,44369,69097,32973,20931,72680,54971,26357,321378
2012-11-01,44965,68669,32909,20916,72603,54935,26307,321304
2012-10-31,44332,68946,32868,20838,72512,54937,26301,320734
2012-10-30,44968,68098,32819,20740,72685,54355,26116,319781
2012-10-29,44787,68095,32752,20667,72554,53400,26127,318382
2012-10-26,44920,67995,32698,20627,72428,53011,26214,317893
2012-10-25,45347,67624,32599,20543,72334,52146,26182,316775
2012-10-24,45904,67145,32552,20476,72162,51829,26175,316243
2012-10-23,46065,67077,32524,20438,71976,50812,26154,315046
2012-10-22,46076,67425,32480,20393,71828,50334,26197,314733
2012-10-19,45814,67359,32467,20364,71660,49619,26175,313458
2012-10-18,46687,66913,32423,20307,71456,49153,26196,313135
2012-10-17,46443,66068,32403,20260,71153,48884,26799,312010
2012-10-16,47106,65848,32381,20224,71098,48634,26811,312102
2012-10-15,46273,66275,32348,20186,71013,48299,26755,311149
2012-10-12,45743,66338,32335,20155,70873,48166,26706,310316
2012-10-11,46142,65786,32260,20115,70672,48880,26617,310472
2012-10-10,46191,65717,32231,20081,70517,49469,26639,310845
2012-10-09,45533,66021,32170,20118,70531,49995,26470,310838
2012-10-05,44918,65940,32154,20143,70573,50219,26450,310397
2012-10-04,45539,65185,32123,20147,70546,50424,26402,310366
2012-10-03,45476,64602,32130,20086,70453,51120,26410,310277
2012-10-02,45789,64382,32107,20014,70377,50839,26423,309931
2012-10-01,45547,65200,32067,20002,70279,51145,26359,310599
2012-09-28,44856,65625,32067,19943,70353,51828,26292,310964
2012-09-27,46057,64291,31984,19909,70675,50585,26310,309811
2012-09-26,46680,63806,31948,19792,70580,49449,26261,308516
2012-09-25,46490,63912,31937,19785,70413,49023,26291,307851
2012-09-21,45722,63835,31892,19745,70281,48616,26223,306314
2012-09-20,46444,63548,31836,19698,70121,48204,26226,306077
2012-09-19,46640,63097,31782,19657,69946,47886,26174,305182
2012-09-18,46465,62954,31739,19623,69732,47713,26204,304430
2012-09-17,46974,63368,31716,19587,69583,47269,26189,304686
2012-09-14,46125,63222,31671,19574,69423,47566,26168,303749
2012-09-13,46875,62848,31633,19536,69243,47932,26159,304226
2012-09-12,47033,62401,31559,19494,69012,48201,26108,303808
2012-09-11,47093,62101,31545,19463,68955,48558,26057,303772
2012-09-10,46524,62353,31534,19446,68983,49475,25917,304232
2012-09-07,45772,62362,31568,19480,69105,50162,25960,304409
2012-09-06,46024,61847,31513,19436,68910,50134,25989,303853
2012-09-05,45687,61524,31484,19412,68903,50627,25798,303435
2012-09-04,45542,61074,31466,19441,68924,50464,25726,302637
2012-09-03,45753,61285,31437,19426,68947,50861,25733,303442
2012-08-31,44543,61720,31430,19356,69081,51003,25619,302752
2012-08-30,45505,60787,31389,19300,69191,50391,25575,302138
2012-08-29,45349,60639,31337,19244,69027,49999,25583,301178
2012-08-28,45738,60361,31299,19211,68884,49388,25581,300462
2012-08-27,46371,60479,31283,19178,68802,48896,25608,300617
2012-08-24,46217,60480,31264,19156,68665,48499,25582,299863
2012-08-23,46228,60021,31193,19102,68507,48007,25634,298692
2012-08-22,46732,59882,31156,19055,68390,47648,25651,298514
2012-08-21,45308,60487,31089,19013,68227,47187,25640,296951
2012-08-17,44842,60627,31064,19023,68061,46867,25707,296191
2012-08-16,45172,60230,31037,18989,67911,46677,25731,295747
2012-08-15,45249,60169,30984,18961,67722,46390,25636,295111
2012-08-14,44893,60062,30943,18932,67578,45933,25602,293943
2012-08-13,45041,60160,30921,18911,67436,45520,25600,293589
2012-08-10,44115,60134,30916,18888,67308,45678,25600,292639
2012-08-09,44047,59638,30868,18914,67278,46201,25584,292530
2012-08-08,43715,59177,30819,18920,67187,46972,25563,292353
2012-08-07,43723,58939,30818,18885,67097,47366,25561,292389
2012-08-06,43346,59095,30792,18865,67030,47482,25434,292044
2012-08-03,42977,59000,30761,18921,67088,47674,25357,291778
2012-08-02,42637,58414,30737,18889,67032,48096,25361,291166
2012-08-01,43330,58250,30689,18872,66947,48087,25329,291504
2012-07-31,42433,58781,30633,18798,66939,48877,25304,291765
2012-07-30,42788,58685,30594,18816,66949,47688,25189,290709
2012-07-27,42663,58581,30506,18764,66931,47584,25128,290157
2012-07-26,43288,58191,30469,18715,66805,47153,25058,289679
2012-07-25,43523,57954,30454,18668,66666,46753,25132,289150
2012-07-24,43708,57752,30444,18635,66618,46222,25146,288525
2012-07-23,43319,57901,30413,18589,66479,45517,25177,287395
2012-07-20,43286,57991,30416,18555,66379,45102,25196,286925
2012-07-19,43380,57581,30379,18541,66243,44823,25203,286150
2012-07-18,43175,57309,30323,18513,66082,44530,25223,285155
2012-07-17,43479,57056,30306,18483,66063,44303,25157,284847
2012-07-16,43694,57469,30302,18459,65917,43872,25142,284855
2012-07-13,42551,57333,30294,18444,65812,43867,24432,282733
2012-07-12,42772,56746,30280,18407,65706,44314,24489,282714
2012-07-11,42544,56390,30267,18394,65603,45301,24506,283005
2012-07-10,41632,56706,30373,18382,65525,45532,24470,282620
2012-07-06,41198,56605,30371,18422,65668,46108,24541,282913
2012-07-05,41503,55945,30351,18417,65642,46345,24465,282668
2012-07-04,41421,55391,30325,18428,65645,46846,24454,282510
2012-07-03,40993,55297,30297,18434,65675,46982,24354,282032
2012-07-02,40611,56035,30234,18409,65665,46983,24242,282179
2012-06-29,39090,56171,30248,18412,65818,48081,24268,282088
2012-06-28,41243,53847,30133,18371,66057,47662,23727,281040
2012-06-27,40920,53129,30094,18291,66005,47176,23651,279266
2012-06-26,41907,52786,30085,18254,65974,46658,23187,278851
2012-06-25,41807,52760,30060,18223,65880,46248,23195,278173
2012-06-22,41797,52767,30029,18240,65749,46099,23040,277721
2012-06-21,41276,52613,29980,18182,65722,45522,22850,276145
2012-06-19,41536,52237,29884,18166,65602,45201,22896,275522
2012-06-18,41813,52239,29829,18157,65466,44782,22870,275156
2012-06-15,41350,52375,29800,18137,65376,44720,22172,273930
2012-06-14,40460,51984,29782,18116,65278,44934,22144,272698
2012-06-13,40264,51562,29730,18084,65147,45207,22113,272107
2012-06-12,39693,51349,29734,18066,65019,45568,22065,271494
2012-06-11,38704,51409,29734,18040,64922,46223,22074,271106
2012-06-08,38101,51308,29732,18079,64920,46404,22020,270564
2012-06-07,38349,50871,29701,18072,64885,46631,21904,270413
2012-06-06,38062,50615,29677,18057,64829,47157,21800,270197
2012-06-05,37927,50358,29674,18032,64813,47301,21670,269775
2012-06-04,37813,50421,29672,18056,64860,47388,21625,269835
2012-06-01,37553,50677,29668,18064,64871,47532,21500,269865
2012-05-31,36631,51240,29606,18030,64863,47221,21465,269056
2012-05-30,37485,50890,29576,17945,64844,46870,21362,268972
2012-05-29,37683,50668,29548,17907,64736,46218,21403,268163
2012-05-28,37533,51159,29531,17876,64769,45157,21355,267380
2012-05-24,37373,50967,29519,17876,64721,44862,21423,266741
2012-05-23,37777,50432,29470,17847,64584,44497,21150,265757
2012-05-22,38303,50320,29616,17832,64419,44179,21056,265725
2012-05-21,37801,50674,29593,17807,64246,43796,21039,264956
2012-05-18,37214,50647,29585,17791,64077,43397,21065,263776
2012-05-17,37503,50110,29551,17787,63915,43154,21146,263166
2012-05-16,37788,50032,29532,17767,63763,43102,21185,263169
2012-05-15,37921,50176,29508,17749,63613,42968,20756,262691
2012-05-14,37306,50243,29503,17741,63487,42722,20790,261792
2012-05-11,37280,50251,29461,17726,63351,42897,20866,261832
2012-05-10,37308,50143,29411,17670,63203,43468,20833,262036
2012-05-09,36716,49859,29402,17688,63227,44638,20886,262416
2012-05-08,36066,49788,29369,17679,63095,44973,20961,261931
2012-05-07,35786,49894,29293,17668,63089,45028,20981,261739
2012-05-04,35438,49817,29287,17697,63145,44962,20994,261340
2012-05-03,35625,49701,29269,17679,63111,45186,20979,261550
2012-05-02,35892,50910,29249,17689,63081,44646,20382,261849
2012-04-27,35041,51180,29241,17680,63072,44841,20497,261552
2012-04-26,35774,50373,29192,17733,63150,44522,20379,261123
2012-04-25,35720,50164,29163,17685,63233,44142,19993,260100
2012-04-24,35824,50071,29140,17666,63160,43850,19996,259707
2012-04-23,35696,50178,28977,17618,63013,42949,19652,258083
2012-04-20,35258,50285,28968,17602,62870,42885,19548,257416
2012-04-19,35548,49759,28938,17580,62726,42680,19519,256750
2012-04-18,35724,49552,28916,17559,62562,42849,19459,256621
2012-04-17,36278,49537,28887,17568,62414,42625,19476,256785
2012-04-16,36295,50176,28882,17546,62318,42481,19454,257152
2012-04-13,35776,50102,28870,17519,62302,42751,19433,256753
2012-04-12,35534,49938,28842,17492,62154,43500,19352,256812
2012-04-11,35341,49618,28794,17470,62049,44256,19378,256906
2012-04-10,35418,49834,28795,17465,61935,44375,19412,257234
2012-04-09,34773,50372,28793,17494,62000,44468,19485,257385
2012-04-04,34868,50206,28796,17529,62232,44672,19455,257758
2012-04-03,34441,50671,28753,17538,62186,44652,19440,257681
2012-03-30,34083,51084,28739,17498,62181,44729,19444,257758
2012-03-29,34623,51049,28698,17579,62343,44689,18462,257443
2012-03-28,34629,50591,28637,17501,62339,44192,18292,256181
2012-03-27,34894,50491,28628,17464,62214,43649,18294,255634
2012-03-26,35167,50714,28604,17442,62065,43018,18330,255340
2012-03-23,35259,50617,28603,17410,61958,42644,18197,254688
2012-03-22,35382,50282,28569,17389,61785,42442,18083,253932
2012-03-21,35763,50085,28551,17361,61594,42305,18101,253760
2012-03-20,35764,50217,28541,17347,61428,42128,18188,253613
2012-03-19,35708,50362,28526,17316,61329,41619,18261,253121
2012-03-16,36055,50442,28515,17292,61196,41623,18320,253443
2012-03-15,35973,50509,28486,17270,61026,42047,18258,253569
2012-03-14,35969,50398,28450,17261,60913,42857,18196,254044
2012-03-13,36768,50293,28426,17240,60772,43080,18237,254816
2012-03-12,36038,50613,28428,17227,60654,42970,18261,254191
2012-03-09,35537,50471,28421,17254,60689,43182,18400,253954
2012-03-08,35249,50145,28330,17233,60556,43668,18392,253573
2012-03-07,35158,49930,28292,17210,60450,44198,18424,253662
2012-03-06,35393,49843,28271,17195,60379,44215,18470,253766
2012-03-05,34997,49896,28240,17198,60318,44125,18596,253370
2012-03-02,34601,49711,28207,17239,60499,44102,18626,252985
2012-03-01,35385,49366,28166,17193,60504,43981,18651,253246
2012-02-29,35049,49860,28144,17182,60396,43814,18625,253070
2012-02-28,35173,50409,28136,17181,60526,43163,18664,253252
2012-02-24,34865,50371,28116,17175,60473,42831,18604,252435
2012-02-23,34746,50163,28084,17158,60337,42061,18160,250709
2012-02-22,34202,50852,28057,17178,60217,41546,18120,250172
2012-02-17,33001,50997,28046,17195,60097,41256,18095,248687
2012-02-16,33282,50744,27992,17172,59930,41097,18030,248247
2012-02-15,33314,50810,27958,17159,59783,40806,18083,247913
2012-02-14,32946,50881,27940,17153,59737,40578,18133,247368
2012-02-13,33294,51075,27938,17133,59733,40423,18126,247722
2012-02-10,32583,51300,27932,17117,59678,40614,18096,247320
2012-02-09,32082,50951,27892,17144,59689,41105,18221,247084
2012-02-08,31918,50807,27869,17124,59576,41561,18198,247053
2012-02-07,31876,50789,27853,17112,59491,41863,18198,247182
2012-02-06,32085,50879,27841,17089,59405,42358,18188,247845
2012-02-03,31952,50880,27831,17108,59450,42619,18152,247992
2012-02-02,31465,50628,27810,17091,59531,42942,18175,247642
2012-02-01,31760,50645,27740,17041,59516,43298,18187,248187
2012-01-31,30885,51214,27720,17017,59589,43741,18189,248355
2012-01-30,31285,51547,27704,16937,59561,43176,18099,248309
2012-01-27,31121,51541,27696,16934,59572,43054,18036,247954
2012-01-26,31382,51289,27669,16901,59502,42789,17643,247175
2012-01-25,31603,51269,27639,16864,59398,42276,17703,246752
2012-01-24,31896,51257,27622,16846,59299,41891,17702,246513
2012-01-23,31478,51529,27599,16816,59175,41503,17638,245738
2012-01-20,31317,51879,27596,16820,59084,41092,17705,245493
2012-01-19,31319,51688,27564,16793,58977,40585,17753,244679
2012-01-18,31636,51607,27547,16750,58855,40541,17770,244706
2012-01-17,32463,51673,27520,16740,58734,40395,17832,245357
2012-01-16,32800,52186,27507,16705,58747,40091,17797,245833
2012-01-13,31780,52217,27472,16695,58663,40294,17823,244944
2012-01-12,31662,51938,27451,16678,58520,40762,17793,244804
2012-01-11,31362,51783,27412,16649,58441,41498,17786,244931
2012-01-10,31283,51935,27342,16627,58343,41885,17781,245196
2012-01-09,30859,52118,27344,16650,58405,42005,17934,245315
2012-01-06,30096,52070,27329,16656,58413,42388,18038,244990
2012-01-05,30108,51849,27284,16640,58383,42524,18096,244884
2012-01-04,30146,52105,27256,16651,58376,42999,18187,245720
2012-01-03,29686,53647,27241,16636,58389,42504,18143,246246
2011-12-30,29365,53630,27391,16613,58513,42942,18147,246601
2011-12-29,30274,53015,27351,16585,58482,41971,18072,245750
2011-12-28,31289,52531,27248,16510,58445,41123,18065,245211
2011-12-27,31284,52637,27157,16490,58439,40892,18063,244962
2011-12-23,31455,52132,27095,16490,58355,40177,18003,243707
2011-12-22,32058,51764,27053,16470,58436,39752,17950,243483
2011-12-21,32203,51189,26976,16447,58342,39319,17849,242325
2011-12-20,31202,51037,26891,16414,58288,38695,17863,240390
2011-12-19,30910,50964,26825,16386,58204,38536,17812,239637
2011-12-16,31331,50681,26759,16368,58097,38461,17802,239499
2011-12-15,31470,50483,26712,16346,57990,38784,17696,239481
2011-12-14,31073,50229,26649,16324,57907,39425,17718,239325
2011-12-13,31686,50072,26602,16305,57785,39717,17701,239868
2011-12-12,30975,50686,26638,16300,57718,39613,17722,239652
2011-12-07,30500,50440,26654,16340,57869,39942,17705,239450
2011-12-06,30964,50269,26570,16309,57774,39970,17724,239580
2011-12-05,30879,50258,26530,16283,57910,39871,17705,239436
2011-12-02,30160,50098,26502,16293,57951,39742,17812,238558
2011-12-01,31038,50012,26460,16263,57922,39625,17656,238976
2011-11-30,30418,50592,26412,16210,57770,39106,17620,238128
2011-11-29,30331,50855,26367,16426,57954,38646,17550,238129
2011-11-25,30114,50783,26332,16415,57908,38382,17567,237501
2011-11-24,30973,50401,26275,16375,57877,37865,17470,237236
2011-11-23,30512,50243,26197,16335,57769,37579,17468,236103
2011-11-22,30983,50200,26129,16307,57641,37199,17497,235956
2011-11-21,30140,50585,26088,16281,57562,36798,17521,234975
2011-11-18,29610,50808,26121,16264,57469,36466,17450,234188
2011-11-17,29974,50524,26083,16224,57302,36206,17466,233779
2011-11-16,30343,50478,26057,16185,57183,36017,17484,233747
2011-11-15,30358,50650,26006,16142,57032,35612,17463,233263
2011-11-14,30032,50733,25978,16125,56911,35506,17450,232735
2011-11-11,30189,50694,25930,16110,56798,35693,17464,232878
2011-11-10,29979,50518,25838,16078,56664,35955,17474,232506
2011-11-09,29915,50266,25777,16072,56774,36410,17523,232737
2011-11-08,30125,50267,25724,16048,56702,36856,17440,233162
2011-11-07,30089,50485,25670,16013,56576,36844,17318,232995
2011-11-04,30063,50495,25647,16013,56574,36981,17341,233114
2011-11-03,29785,50077,25611,15954,56433,37131,17403,232394
2011-11-02,29816,49885,25550,15922,56358,37588,17400,232519
2011-11-01,30308,50142,25499,15892,56395,37424,17333,232993
2011-10-31,29434,50766,25467,15846,56298,38107,17328,233246
2011-10-28,29670,50751,25443,15783,56241,37198,17222,232308
2011-10-27,30075,50406,25330,15726,56153,36911,16866,231467
2011-10-26,30356,50191,25283,15643,56078,36597,16842,230990
2011-10-25,30574,50200,25251,15595,56066,36067,16905,230658
2011-10-24,30386,50245,25211,15550,55920,35609,16846,229767
2011-10-21,29900,50349,25187,15499,55766,35458,16868,229027
2011-10-20,29935,50247,25113,15447,55588,35017,16975,228322
2011-10-19,29881,50064,25064,15396,55397,34761,16924,227487
2011-10-18,30409,50047,24996,15355,55306,34445,16894,227452
2011-10-17,30627,50414,24954,15322,55055,33954,16852,227178
2011-10-14,29782,50439,24933,15317,54906,33876,16839,226092
2011-10-13,29787,50062,24808,15266,54741,34215,16852,225731
2011-10-12,30292,49956,24761,15237,54560,34828,16908,226542
2011-10-11,29369,50361,24729,15211,54417,35041,16876,226004
2011-10-07,28775,50291,24725,15231,54477,35255,16882,225636
2011-10-06,28638,49945,24678,15198,54331,35396,16787,224973
2011-10-05,28688,49747,24649,15147,54245,35805,16815,225096
2011-10-04,28752,49549,24571,15139,54177,36016,16845,225049
2011-10-03,28922,49748,24552,15100,54073,35932,16822,225149
2011-09-30,28104,50426,24553,15084,53991,36017,16804,224979
2011-09-29,28511,49606,24482,14970,54133,35577,16726,224005
2011-09-28,28607,48960,24414,14887,54102,35278,16689,222937
2011-09-27,29277,48664,24369,14838,53969,34610,16659,222386
2011-09-26,28955,48783,24321,14816,53808,34104,16664,221451
2011-09-23,28603,48763,24293,14795,53855,33981,16615,220905
2011-09-22,28690,48340,24218,14760,53689,33720,16629,220046
2011-09-21,28761,48148,24181,14677,53499,33519,16586,219371
2011-09-20,28720,48153,24147,14631,53351,33263,16584,218849
2011-09-19,28792,48142,24122,14595,53177,32943,16517,218288
2011-09-16,29270,48251,24086,14580,52970,33013,16400,218570
2011-09-15,29046,48084,24027,14535,52784,33286,16356,218118
2011-09-14,28693,47946,23972,14496,52563,33794,16306,217770
2011-09-13,29349,47589,23911,14470,52380,34162,16268,218129
2011-09-12,29132,47753,23909,14441,52169,34038,16187,217629
2011-09-09,28537,47654,23878,14443,52144,34169,16189,217014
2011-09-08,28392,47243,23844,14399,52148,34592,16097,216715
2011-09-07,28645,46711,23807,14341,52003,34869,16064,216440
2011-09-06,28527,46565,23784,14313,51897,34800,16078,215964
2011-09-05,28715,46511,23771,14277,51791,34806,16097,215968
2011-09-02,27858,46329,23760,14278,51775,34789,16117,214906
2011-09-01,28328,45644,23669,14235,51678,34710,16102,214366
2011-08-31,27691,45867,23657,14185,51693,34998,16103,214194
2011-08-30,28198,45624,23600,14068,51690,33914,16004,213098
2011-08-29,27910,45544,23556,14029,51598,33514,15941,212092
2011-08-26,28403,45363,23526,13995,51469,33394,15858,212008
2011-08-25,28839,45007,23481,13950,51270,33064,15727,211338
2011-08-24,29186,44810,23431,13921,51104,32707,15798,210957
2011-08-23,28829,45213,23406,13887,50952,32228,15756,210271
2011-08-19,28115,45138,23371,13873,50807,31893,15813,209010
2011-08-18,28262,44708,23292,13840,50622,31682,15632,208038
2011-08-17,28233,44441,23261,13813,50445,31437,15631,207261
2011-08-16,28337,44555,23229,13779,50305,31202,15607,207014
2011-08-15,28198,44707,23205,13780,50152,30942,15607,206591
2011-08-12,27839,44707,23181,13727,50075,30966,15645,206140
2011-08-11,27833,44285,23134,13717,49952,31257,15646,205824
2011-08-10,27945,44190,23119,13698,49814,31769,15638,206173
2011-08-09,28207,44084,23101,13643,49826,32095,15650,206606
2011-08-08,27689,44128,23078,13615,49703,32218,15658,206089
2011-08-05,27511,44142,23019,13598,49643,32351,15711,205975
2011-08-04,27552,43845,22996,13598,49548,32488,15770,205797
2011-08-03,27606,43498,22925,13562,49554,32918,15759,205822
2011-08-02,27666,43322,22893,13523,49505,32998,15887,205794
2011-08-01,27948,44067,22868,13496,49452,32859,15864,206554
2011-07-29,27633,44270,22860,13479,49470,33098,15820,206630
2011-07-28,27957,43570,22807,13409,49495,32527,15821,205586
2011-07-27,27885,43314,22781,13341,49423,32168,15717,204629
2011-07-26,28569,43218,22757,13311,49301,31753,15472,204381
2011-07-25,29003,43305,22735,13269,49187,31189,15452,204140
2011-07-22,28863,43230,22704,13246,49153,30917,15491,203604
2011-07-21,28917,42854,22684,13203,49003,30668,15496,202825
2011-07-20,29253,42625,22661,13182,48880,30501,15476,202578
2011-07-19,29449,42505,22610,13177,48793,30294,15503,202331
2011-07-18,29782,42650,22591,13133,48652,30019,15510,202337
2011-07-15,29641,42947,22556,13114,48534,30090,15272,202154
2011-07-14,29115,42511,22528,13083,48425,30437,15308,201407
2011-07-13,29384,42366,22499,13063,48318,31070,13782,200482
2011-07-12,29115,42292,22496,13042,48196,31409,13796,200346
2011-07-11,28984,42357,22489,13018,48120,31450,13743,200161
2011-07-08,28532,42285,22460,13032,48166,31820,13755,200050
2011-07-07,28602,41936,22426,13016,48091,32022,13736,199829
2011-07-06,28676,41607,22382,12985,48086,32355,13722,199813
2011-07-05,28246,41520,22370,12974,48049,32559,13720,199438
2011-07-04,28102,41513,22339,12981,48050,32597,13616,199198
2011-07-01,28092,41633,22315,12946,48037,32525,13610,199158
2011-06-30,27387,42172,22271,12971,47977,33529,12089,198396
2011-06-29,27648,41460,22209,12840,48140,32809,12058,197164
2011-06-28,27403,40975,22173,12780,48093,32371,11998,195793
2011-06-27,27767,40927,22157,12719,48078,31973,11922,195543
2011-06-24,27735,40778,22117,12682,47965,31543,11940,194760
2011-06-23,27985,40296,22089,12643,47856,31241,11903,194013
2011-06-22,28373,40103,22030,12618,47742,30678,11899,193443
2011-06-21,28069,40442,22012,12596,47616,30398,11948,193081
2011-06-17,27984,40328,22001,12573,47536,30000,11958,192380
2011-06-16,28628,40021,21939,12535,47423,29782,11592,191920
2011-06-15,28532,40104,21902,12497,47300,29661,11581,191577
2011-06-14,27894,39904,21894,12474,47178,29408,11582,190334
2011-06-13,27941,39943,21881,12432,47051,29152,11609,190009
2011-06-10,27079,40071,21881,12412,46898,29175,11649,189165
2011-06-09,27185,39583,21862,12403,46968,29562,11626,189189
2011-06-08,26815,39399,21835,12381,46856,30311,11593,189190
2011-06-07,26560,39338,21814,12344,46833,30592,11573,189054
2011-06-06,26468,39541,21808,12323,46760,30764,11538,189202
2011-06-03,26270,39427,21813,12326,46782,30914,11570,189102
2011-06-02,26281,38995,21791,12290,46721,31348,11570,188996
2011-06-01,26469,38956,21762,12257,46672,31400,11565,189081
2011-05-31,25851,39394,21754,12230,46567,32099,11558,189453
2011-05-30,26641,39655,21719,12183,46669,31031,11411,189309
2011-05-27,26036,39597,21680,12130,46638,30778,11338,188197
2011-05-26,26469,39521,21662,12097,46533,30354,11263,187899
2011-05-24,26462,39373,21644,12067,46439,29905,11286,187176
2011-05-23,26269,39426,21616,12029,46299,29416,11301,186356
2011-05-20,25843,39522,21596,12013,46268,29267,11353,185862
2011-05-19,25638,39231,21517,11967,46168,28843,11274,184638
2011-05-18,26035,39081,21485,11938,45997,28635,11276,184447
2011-05-17,26324,39084,21456,11899,45867,28450,11254,184334
2011-05-16,26306,39453,21437,11873,45733,28153,11227,184182
2011-05-13,25905,39395,21413,11860,45614,28198,11197,183582
2011-05-12,25469,38884,21371,11806,45439,28557,11113,182639
2011-05-11,25152,38755,21346,11779,45303,29104,11090,182529
2011-05-10,25128,38808,21336,11778,45206,29452,11094,182802
2011-05-09,24707,38784,21327,11782,45243,29565,10982,182390
2011-05-06,24575,38574,21315,11764,45273,29748,11010,182259
2011-05-05,24609,38265,21300,11724,45167,29766,11028,181859
2011-05-04,24564,37945,21285,11726,45106,30033,11021,181680
2011-05-03,24461,37641,21269,11711,45052,30191,11042,181367
2011-05-02,24066,38305,21255,11693,44978,30116,11031,181444
2011-04-29,23594,38517,21244,11686,44974,30641,10908,181564
2011-04-28,24185,37860,21214,11625,45202,30027,10802,180915
2011-04-27,23977,37715,21210,11552,45214,29557,10671,179896
2011-04-26,24373,37530,21190,11509,45114,28772,10681,179169
2011-04-25,24375,37914,21169,11495,44942,28666,10730,179291
2011-04-20,24014,37916,21169,11480,44807,28186,10748,178320
2011-04-19,24430,37617,21147,11451,44674,28103,10793,178215
2011-04-18,23927,37633,21121,11413,44521,27894,10816,177325
2011-04-15,23494,37832,21113,11397,44388,27909,10783,176916
2011-04-14,23114,37514,21090,11359,44257,28195,10771,176300
2011-04-13,23292,37260,21073,11329,44118,28656,10762,176490
2011-04-12,23307,37206,21034,11300,43978,28898,10783,176506
2011-04-11,23112,37283,21039,11268,43855,28876,10768,176201
2011-04-08,22784,37260,21034,11280,43889,29166,10774,176187
2011-04-07,22765,37004,20992,11260,43739,29232,10745,175737
2011-04-06,22667,36791,20976,11240,43635,29551,10773,175633
2011-04-05,22937,36573,20972,11214,43571,29448,10782,175497
2011-04-04,23071,36608,20957,11208,43522,29533,10803,175702
2011-04-01,22905,36595,20950,11195,43499,29737,10762,175643
2011-03-31,22504,36763,20944,11169,43443,30143,10528,175494
2011-03-30,23051,36409,20912,11118,43462,29330,10592,174874
2011-03-29,23323,36155,20889,11048,43444,28669,10582,174110
2011-03-28,23225,36640,20890,11014,43434,28434,10498,174135
2011-03-23,22790,36530,20885,10991,43319,28019,10496,173030
2011-03-22,23272,36240,20850,10969,43200,27704,10419,172654
2011-03-21,23003,36528,20931,10932,43082,27756,10336,172568
2011-03-18,22875,36475,20945,10911,42989,27813,10363,172371
2011-03-17,23159,36182,20924,10883,42842,28059,10368,172417
2011-03-16,23540,36017,21032,10848,42698,28558,10377,173070
2011-03-15,23511,36065,20997,10825,42551,28823,10302,173074
2011-03-14,23055,36019,20987,10812,42437,28667,10363,172340
2011-03-11,23077,35984,20964,10790,42328,28776,10443,172362
2011-03-10,23474,35860,20959,10776,42196,29290,10397,172952
2011-03-09,23463,36289,20946,10783,42240,28992,10310,173023
2011-03-04,23468,36330,20948,10807,42236,29277,10320,173386
2011-03-03,23101,35902,20924,10761,42166,29384,10285,172523
2011-03-02,23061,35602,20883,10736,42188,29020,10298,171788
2011-03-01,23564,35521,20873,10720,42309,28750,10284,172021
2011-02-28,23191,36206,20817,10716,42164,29402,10281,172777
2011-02-25,23456,36079,20833,10682,42390,28107,10238,171785
2011-02-24,23605,35659,20804,10623,42335,27931,10229,171186
2011-02-23,23691,35527,20790,10592,42218,27726,10134,170678
2011-02-22,23547,35457,20775,10542,42075,27724,10154,170274
2011-02-21,23394,35693,20759,10520,41990,27455,10157,169968
2011-02-18,22979,35722,20737,10509,41875,27255,10204,169281
2011-02-17,23397,35515,20714,10472,41803,27084,10218,169203
2011-02-16,23881,35401,20697,10439,41974,26962,10230,169584
2011-02-15,23385,35569,20677,10419,41867,27167,10245,169329
2011-02-14,23104,35744,20653,10398,41754,27009,10264,168926
2011-02-11,23062,35681,20652,10377,41647,27040,10286,168745
2011-02-10,22874,35527,20629,10353,41553,27451,10299,168686
2011-02-09,22576,35364,20626,10349,41567,27606,10350,168438
2011-02-08,22719,35324,20614,10318,41465,27751,10392,168583
2011-02-07,23076,35468,20605,10301,41404,27957,10433,169244
2011-02-04,22272,35458,20605,10298,41370,27999,10453,168455
2011-02-03,22158,35068,20585,10260,41360,28089,10428,167948
2011-02-02,22055,34932,20571,10221,41324,28450,10466,168019
2011-02-01,22354,34996,20563,10204,41269,28483,10746,168615
2011-01-31,21886,35783,20532,10176,41163,29026,10737,169303
2011-01-28,22069,35619,20551,10148,41289,28403,10689,168768
2011-01-27,22208,35394,20566,10110,41279,28208,10689,168454
2011-01-26,22293,35135,20551,10066,41191,27977,10734,167947
2011-01-25,22654,35089,20535,10016,41105,27664,10813,167876
2011-01-24,22445,35207,20527,9976,41013,27335,10761,167264
2011-01-21,22307,35258,20526,9948,40923,26879,10779,166620
2011-01-20,22487,35116,20513,9910,40815,26849,10622,166312
2011-01-19,22357,34928,20508,9861,40721,26725,10704,165804
2011-01-18,22548,35026,20468,9836,40592,26615,10707,165792
2011-01-17,22423,35458,20484,9810,40481,26443,10739,165838
2011-01-14,21732,35509,20485,9788,40464,26432,10835,165245
2011-01-13,21823,35289,20442,9762,40346,26746,10872,165280
2011-01-12,21768,35250,20430,9733,40243,27221,10879,165524
2011-01-11,21623,35120,20412,9704,40144,27533,10876,165412
2011-01-10,21415,35330,20413,9675,40053,27519,10925,165330
2011-01-07,20841,35310,20418,9676,40160,27759,10976,165140
2011-01-06,21014,35088,20395,9654,40097,27825,11026,165099
2011-01-05,20719,34992,20367,9646,40043,28103,11081,164951
2011-01-04,21054,35068,20375,9655,40070,28196,11110,165528
2011-01-03,20751,35958,20357,9647,40029,28164,11147,166053
2010-12-30,20399,36161,20263,9635,39991,28625,11080,166154
2010-12-29,21749,35643,20254,9639,39982,27755,10904,165926
2010-12-28,22598,35027,20187,9606,39970,27342,10873,165603
2010-12-27,22646,35246,20152,9581,39925,26750,10842,165142
2010-12-23,22862,34984,20125,9562,39818,26222,10797,164370
2010-12-22,23049,34460,20067,9534,39719,25982,10783,163594
2010-12-21,22901,34045,20024,9507,39627,25695,10779,162578
2010-12-20,22384,34089,19995,9474,39526,25576,10765,161809
2010-12-17,22078,33871,19921,9422,39400,25495,10747,160934
2010-12-16,22237,33426,19880,9397,39387,25548,10761,160636
2010-12-15,22044,33362,19881,9358,39276,26036,10749,160706
2010-12-14,22114,33056,19863,9343,39173,26045,10774,160368
2010-12-13,21997,33055,19850,9335,39052,26018,10775,160082
2010-12-10,22088,33083,19833,9315,38971,26107,10793,160190
2010-12-09,21602,32724,19785,9314,38983,26428,10898,159734
2010-12-07,21749,32606,19766,9307,38922,26514,10910,159774
2010-12-06,21527,32618,19747,9288,38882,26424,10885,159371
2010-12-03,21413,32409,19742,9278,38930,26387,10625,158784
2010-12-02,21776,32074,19720,9255,38856,26466,10587,158734
2010-12-01,22016,32045,19820,9226,38794,26184,10552,158637
2010-11-30,21478,32490,19747,9206,38739,26525,10546,158731
2010-11-29,21728,32393,19765,9185,38854,25722,10502,158149
2010-11-26,21658,32239,19755,9151,38799,25473,10414,157489
2010-11-25,22087,31913,19726,9109,38730,25072,10406,157043
2010-11-24,22065,31778,19706,9079,38627,24747,10357,156359
2010-11-23,22047,32178,19691,9053,38626,24453,10327,156375
2010-11-19,21475,32206,19679,9041,38477,24187,10337,155402
2010-11-18,21721,31922,19650,9005,38354,23992,10322,154966
2010-11-17,21736,31647,19662,8977,38258,23824,10342,154446
2010-11-16,22187,31607,19641,9018,38139,23724,10368,154684
2010-11-15,22015,31896,19623,8992,38011,23548,10339,154424
2010-11-12,21372,31871,19607,8978,37916,23546,10349,153639
2010-11-11,21280,31599,19556,8950,37824,23810,10335,153354
2010-11-10,20779,31536,19544,8922,37691,24268,10344,153084
2010-11-09,20850,31452,19530,8923,37739,24479,10334,153307
2010-11-08,20862,31422,19501,8904,37642,24640,10384,153355
2010-11-05,20887,31446,19462,8900,37601,24712,10396,153404
2010-11-04,21086,31149,19440,8903,37568,24822,10012,152980
2010-11-03,21030,30978,19424,8875,37486,25060,9993,152846
2010-11-02,21678,30899,19412,8852,37422,25264,9992,153519
2010-11-01,21510,31294,19407,8832,37353,25257,9950,153603
2010-10-29,21290,31470,19342,8817,37312,25376,9920,153527
2010-10-28,22024,31017,19315,8822,37560,24578,9824,153140
2010-10-26,22288,30814,19287,8785,37510,24325,9804,152813
2010-10-25,22168,30840,19254,8758,37424,23937,9764,152145
2010-10-22,21974,30739,19236,8733,37330,23756,9737,151505
2010-10-21,21832,30478,19210,8715,37168,23565,9405,150373
2010-10-20,21933,30480,19193,8700,37059,23384,9454,150203
2010-10-19,21693,30389,19178,8669,36965,23208,9481,149583
2010-10-18,22033,30527,19178,8651,36835,22923,9500,149647
2010-10-15,21944,30635,19130,8640,36709,22873,9486,149417
2010-10-14,21442,30344,19149,8636,36601,23092,9439,148703
2010-10-13,21281,30259,19127,8611,36588,23541,9431,148838
2010-10-12,21136,30492,19116,8600,36485,23597,9410,148836
2010-10-08,20587,30451,19119,8605,36532,23946,9413,148653
2010-10-07,20709,30148,19109,8586,36469,23961,9422,148404
2010-10-06,20784,30049,19097,8565,36403,24207,9457,148562
2010-10-05,20817,29957,19084,8543,36394,24421,9452,148668
2010-10-04,20780,29919,19062,8538,36330,24453,9437,148519
2010-10-01,20936,29996,19058,8513,36277,24428,9424,148632
2010-09-30,20416,30319,18986,8480,36176,24529,9416,148322
2010-09-29,20926,29916,18978,8475,36325,24093,9195,147908
2010-09-28,20967,29726,18961,8432,36296,23830,9148,147360
2010-09-27,20938,29781,18934,8408,36214,23647,9054,146976
2010-09-24,21129,29677,18878,8387,36106,23116,9042,146335
2010-09-23,20832,29361,18858,8357,36009,22938,9041,145396
2010-09-22,20990,29134,18825,8341,35923,22774,8935,144922
2010-09-21,20787,29067,18801,8314,35783,22551,8944,144247
2010-09-20,20776,29319,18791,8292,35653,22298,8969,144098
2010-09-17,20375,29226,18785,8284,35569,22114,9113,143466
2010-09-16,20643,28948,18758,8258,35451,21965,9081,143104
2010-09-15,20629,29091,18786,8232,35394,21835,8971,142938
2010-09-14,20181,29037,18769,8213,35300,21721,9060,142281
2010-09-13,20429,29011,18755,8189,35197,21527,8912,142020
2010-09-10,19733,29079,18757,8167,35110,21785,8942,141573
2010-09-09,20032,28841,18763,8166,35224,22022,8880,141928
2010-09-08,19964,28660,18753,8142,35116,22489,8916,142040
2010-09-07,20314,28552,18733,8121,35075,22821,8929,142545
2010-09-06,20188,28605,18733,8111,35005,22864,8944,142450
2010-09-03,19848,28559,18736,8117,35028,23022,8933,142243
2010-09-02,19883,28247,18717,8104,34971,23377,8906,142205
2010-09-01,20382,28178,18701,8090,34901,23397,8917,142566
2010-08-31,20074,28441,18643,8047,34848,23945,8930,142928
2010-08-30,20586,28515,18667,8065,34918,23179,8817,142747
2010-08-27,20371,28357,18623,8096,34907,23061,8801,142216
2010-08-26,20607,28079,18599,8061,34837,22895,8822,141900
2010-08-25,20804,28002,18582,8040,34803,22606,8894,141731
2010-08-24,20898,27915,18549,8023,34701,22333,8883,141302
2010-08-23,20858,27970,18536,8008,34593,21969,8872,140806
2010-08-20,20493,28035,18530,7996,34510,21814,8923,140301
2010-08-19,20639,27746,18506,7985,34427,21559,8992,139854
2010-08-18,20957,27664,18499,7970,34326,21337,9015,139768
2010-08-17,20964,28026,18524,7955,34230,21179,9028,139906
2010-08-13,20332,27969,18524,7953,34175,21192,9069,139214
2010-08-12,20257,27748,18498,7935,34103,21436,9035,139012
2010-08-11,20216,27599,18481,7922,34104,21779,9066,139167
2010-08-10,20110,27651,18467,7917,34054,21897,9082,139178
2010-08-09,19824,27721,18458,7928,34073,22009,9086,139099
2010-08-06,19632,27677,18450,7927,34051,22095,9089,138921
2010-08-05,20020,27417,18430,7921,34024,22201,9101,139114
2010-08-04,19959,27336,18428,7916,34040,22346,9120,139145
2010-08-03,20157,27175,18413,7908,34018,22408,9105,139184
2010-08-02,20153,27483,18408,7899,33973,22494,9074,139484
2010-07-30,19757,27934,18374,7864,33909,22699,9047,139584
2010-07-29,19996,27492,18344,7886,33999,22233,9011,138961
2010-07-28,19971,27296,18320,7857,33934,22130,8805,138313
2010-07-27,20138,27195,18313,7851,33979,21829,8810,138115
2010-07-26,20444,27295,18301,7839,33914,21507,8827,138127
2010-07-23,20095,27228,18298,7839,33844,21113,8820,137237
2010-07-22,20378,26854,18336,7833,33772,20947,8771,136891
2010-07-21,20306,26693,18332,7826,33699,20833,8766,136455
2010-07-20,20534,26719,18346,7822,33629,20778,8790,136618
2010-07-19,20400,26824,18620,7819,33577,20608,8812,136660
2010-07-16,20799,26796,18583,7818,33510,20510,8825,136841
2010-07-15,20796,26698,18599,7808,33452,20766,8816,136935
2010-07-14,20445,26611,18595,7810,33395,21256,8754,136866
2010-07-13,20409,26562,18586,7808,33410,21420,8744,136939
2010-07-12,20134,26861,18593,7808,33359,21462,8759,136976
2010-07-08,19989,26619,18593,7833,33419,21793,8746,136992
2010-07-07,19940,26433,18580,7831,33348,22058,8726,136916
2010-07-06,20327,26257,18569,7827,33324,22111,8734,137149
2010-07-05,20313,26260,18563,7827,33312,22001,8766,137042
2010-07-02,19699,26154,18564,7843,33372,22154,8784,136570
2010-07-01,20213,25965,18552,7836,33362,22097,8714,136739
2010-06-30,19453,26357,18524,7829,33278,22952,8686,137079
2010-06-29,20117,25944,18507,7830,33448,22459,8510,136815
2010-06-28,20212,25729,18505,7674,33426,22099,8455,136100
2010-06-25,20192,25646,18507,7663,33349,21858,8367,135582
2010-06-24,20471,25321,18496,7643,33315,21615,8210,135071
2010-06-23,20213,25180,18482,7624,33261,21274,8212,134246
2010-06-22,20431,25504,18480,7617,33203,21065,8187,134487
2010-06-18,19711,25535,18506,7616,33185,20826,8173,133552
2010-06-17,20004,25328,18494,7596,33089,20651,8208,133370
2010-06-16,20626,25235,18473,7587,33095,20540,8218,133774
2010-06-15,20158,25327,18468,7574,33035,20384,8228,133174
2010-06-14,19857,25523,18333,7574,32990,20200,8119,132596
2010-06-11,19748,25451,18334,7570,32985,20176,8183,132447
2010-06-10,19676,25323,18347,7564,32924,20493,8175,132502
2010-06-09,19663,25138,18345,7576,32963,20934,8157,132776
2010-06-08,19935,25086,18329,7560,32913,21093,8202,133118
2010-06-07,19953,25167,18321,7559,32915,21093,8224,133232
2010-06-04,19673,25012,18326,7572,32909,21220,8213,132925
2010-06-03,19563,24756,18321,7563,32933,21393,8129,132658
2010-06-02,19346,24601,18317,7623,32916,21643,8125,132571
2010-06-01,19988,24520,18316,7609,32842,21577,8146,132998
2010-05-31,19448,25229,18329,7582,32853,21893,8057,133391
2010-05-28,19480,25033,18272,7566,33056,21201,7712,132320
2010-05-27,19945,24736,18268,7546,33017,20665,7650,131827
2010-05-26,20060,24978,18272,7534,32986,20261,7629,131720
2010-05-21,18967,24945,18273,7537,32945,20012,7613,130292
2010-05-20,19289,24860,18267,7521,32869,19905,7542,130253
2010-05-19,19022,24722,18256,7519,32885,19775,7564,129743
2010-05-18,19761,24715,18252,7506,32793,19481,7590,130098
2010-05-17,19990,24942,18248,7501,32719,19440,7568,130408
2010-05-14,19894,24996,18275,7503,32663,19726,7500,130557
2010-05-13,19584,24792,18267,7497,32589,19953,7455,130137
2010-05-12,19058,24684,18267,7486,32506,20008,7432,129441
2010-05-11,19147,24577,18222,7477,32442,20239,7458,129562
2010-05-10,18688,24734,18227,7502,32387,20353,7490,129381
2010-05-07,18182,24749,18235,7520,32441,20488,7499,129114
2010-05-06,18026,24540,18235,7514,32385,20596,7533,128829
2010-05-05,18001,24383,18220,7511,32327,20810,7522,128774
2010-05-04,18036,24306,18218,7515,32318,20926,7540,128859
2010-05-03,18328,24445,18215,7515,32349,20919,7527,129298
2010-04-30,17595,24903,18194,7502,32430,20880,7453,128957
2010-04-29,17706,24598,18181,7497,32478,20575,7419,128454
2010-04-28,17731,24441,18167,7477,32546,20314,7320,127996
2010-04-27,18009,24404,18166,7443,32490,19990,7327,127829
2010-04-26,18039,24460,18170,7425,32421,19441,7231,127187
2010-04-23,17865,24374,18172,7408,32339,19302,7239,126699
2010-04-22,17803,24155,18165,7397,32270,19233,7211,126234
2010-04-21,17792,24031,18162,7384,32203,19152,7223,125947
2010-04-20,17838,24119,18157,7376,32137,19104,7221,125952
2010-04-19,17708,24153,18196,7368,32077,18846,7228,125576
2010-04-16,17740,24212,18197,7365,32012,18873,7242,125641
2010-04-15,17541,24181,18163,7354,31935,18891,7243,125308
2010-04-14,17058,24120,18158,7354,31867,19413,7235,125205
2010-04-13,17359,24068,18143,7349,31794,19509,7268,125490
2010-04-12,17202,24168,18150,7340,31732,19683,7262,125537
2010-04-09,16856,24078,18159,7357,31803,19870,7284,125407
2010-04-08,16918,23831,18147,7350,31745,20009,7321,125321
2010-04-07,16577,23711,18143,7345,31715,20165,7336,124992
2010-04-06,16961,23631,18133,7338,31688,20021,7358,125130
2010-04-05,16873,23877,18126,7338,31669,20086,7296,125265
2010-03-31,15970,24086,18125,7338,31670,20291,7279,124759
2010-03-30,16432,23677,18071,7329,31680,19893,7247,124329
2010-03-29,16185,23539,18047,7304,31644,19614,7208,123541
2010-03-26,16327,23454,18048,7294,31637,19259,7151,123170
2010-03-25,16456,23322,18023,7287,31584,19071,7031,122774
2010-03-23,16406,23236,18023,7289,31519,18791,7065,122329
2010-03-22,16478,23301,18008,7262,31442,18572,7103,122166
2010-03-19,16238,23246,18004,7262,31389,18436,7142,121717
2010-03-18,16523,23141,18046,7260,31384,18368,7122,121844
2010-03-17,16593,23080,18034,7251,31317,18281,7109,121665
2010-03-16,16812,23102,18032,7239,31245,18152,7125,121707
2010-03-15,16751,23313,18028,7227,31218,18057,7059,121653
2010-03-12,16517,23312,18036,7224,31180,18132,7064,121465
2010-03-11,16778,23092,17980,7212,31123,18485,7071,121741
2010-03-10,16525,23093,17980,7198,31078,18571,7093,121538
2010-03-09,16568,23061,17984,7211,31100,18781,7119,121824
2010-03-08,16505,23086,17985,7209,31054,19247,7156,122242
2010-03-05,16269,23001,17984,7216,31098,19196,7179,121943
2010-03-04,16245,22820,17972,7223,31063,19206,7186,121715
2010-03-03,16286,22667,17969,7214,31073,19133,7189,121531
2010-03-02,16600,22676,17971,7214,31070,19253,7205,121989
2010-03-01,16670,23009,17965,7218,31021,19438,7209,122530
2010-02-26,16087,23360,17969,7223,31054,19341,7104,122138
2010-02-25,16480,22918,17946,7216,31184,19140,7014,121898
2010-02-24,16403,22742,17902,7191,31163,18932,7025,121358
2010-02-23,16557,22655,17894,7185,31120,18672,7049,121132
2010-02-22,16436,22810,17895,7183,31056,18291,7036,120707
2010-02-19,16368,22793,17818,7184,31110,18164,7058,120495
2010-02-18,16493,22639,17817,7174,31049,18127,7084,120383
2010-02-17,16561,22503,17810,7172,30977,17974,7106,120103
2010-02-16,16908,22559,17812,7165,30919,17903,7086,120352
2010-02-15,16679,22811,17808,7161,30859,17809,7080,120207
2010-02-12,16529,22825,17813,7170,30822,17918,7040,120117
2010-02-11,16475,22684,17803,7170,30761,18130,7012,120035
2010-02-10,16485,22702,17806,7166,30717,18463,7014,120353
2010-02-09,16383,22661,17801,7169,30746,18585,7048,120393
2010-02-08,16313,22722,17802,7161,30700,18670,7051,120419
2010-02-05,16139,22768,17803,7163,30680,18833,7046,120432
2010-02-04,16354,22569,17805,7172,30701,18862,7065,120528
2010-02-03,16266,22418,17799,7171,30695,19048,7083,120480
2010-02-02,16425,22297,17806,7167,30700,19168,7068,120631
2010-02-01,16648,22644,17802,7166,30707,19111,7065,121143
2010-01-29,16070,22840,17779,7164,30675,19199,7043,120770
2010-01-28,16408,22533,17740,7161,30783,19005,7053,120683
2010-01-27,16590,22459,17740,7152,30849,18756,7051,120597
2010-01-26,17035,22436,17739,7142,30759,18533,7022,120666
2010-01-25,16998,22520,17740,7133,30702,18372,7057,120522
2010-01-22,16956,22582,17750,7129,30656,18234,7091,120398
2010-01-21,16997,22544,17741,7114,30605,18114,7089,120204
2010-01-20,16844,22579,17780,7086,30553,17970,7113,119925
2010-01-19,17135,22540,17768,7086,30517,17904,7113,120063
2010-01-18,17361,22702,17771,7077,30462,17717,7106,120196
2010-01-15,17100,22914,17773,7069,30410,17812,7011,120089
2010-01-14,17250,22709,17772,7074,30341,18007,7093,120246
2010-01-13,17165,22675,17777,7048,30282,18302,7104,120353
2010-01-12,17289,22675,17737,7039,30209,18713,7132,120794
2010-01-11,17054,22812,17752,7041,30181,18877,7120,120837
2010-01-08,16639,22785,17753,7047,30209,19049,7141,120623
2010-01-07,16497,22537,17751,7048,30271,19159,7186,120449
2010-01-06,16177,22456,17749,7042,30258,19418,7201,120301
2010-01-05,16633,22531,17741,7048,30254,19458,7228,120893
2010-01-04,16032,23177,17745,7065,30244,19362,7224,120849
2009-12-31,16491,23400,17743,7076,30281,19537,7229,121757
2009-12-30,16731,23321,17713,7072,30279,19209,7233,121558
2009-12-29,16976,22999,17673,7057,30286,18868,7138,120997
2009-12-28,17615,23039,17670,7067,30264,18684,6816,121155
2009-12-24,17704,22846,17657,7075,30240,18289,6806,120617
2009-12-23,18181,22847,17651,7073,30201,17974,6680,120607
2009-12-22,18212,22548,17628,7067,30160,17750,6547,119912
2009-12-21,17982,22484,17613,7057,30145,17623,6605,119509
2009-12-18,17781,22480,17641,7068,30120,17360,6655,119105
2009-12-17,17968,22148,17632,7059,30077,17168,6650,118702
2009-12-16,18113,21948,17834,7039,30020,17074,6643,118671
2009-12-15,17945,21977,17827,7040,29971,16945,6611,118316
2009-12-14,17878,21987,17830,7045,29931,16842,6578,118091
2009-12-11,17554,21933,17828,7046,29885,16830,6625,117701
2009-12-10,17799,21775,17827,7040,29842,16888,6523,117694
2009-12-09,17878,21846,17818,7052,29883,17160,6555,118192
2009-12-07,17509,21917,17817,7055,29906,17562,6509,118275
2009-12-04,17268,21841,17817,7069,29925,17689,6559,118168
2009-12-03,17272,21641,17800,7068,29934,17720,6561,117996
2009-12-02,17192,21514,17796,7051,29930,17733,6589,117805
2009-12-01,17437,21499,17789,7056,29934,17762,6582,118059
2009-11-30,16615,22009,17782,7060,29931,18093,6378,117868
2009-11-27,17158,21734,17765,7061,29936,17800,6478,117932
2009-11-26,17061,21574,17760,7041,29899,17577,6444,117356
2009-11-25,17002,21457,17735,7029,29877,17413,6457,116970
2009-11-24,17230,21346,17737,7015,29829,17212,6456,116825
2009-11-23,17094,21421,17730,7008,29764,17004,6442,116463
2009-11-20,16890,21523,17734,7004,29772,16717,6461,116101
2009-11-19,17131,21371,17703,7001,29711,16543,6468,115928
2009-11-18,17102,21336,17763,6998,29644,16387,6383,115613
2009-11-17,17383,21353,17758,6993,29589,16308,6360,115744
2009-11-16,17425,21566,17756,6990,29531,16326,6373,115967
2009-11-13,17195,21568,17760,6995,29479,16188,6381,115566
2009-11-12,17142,21399,17754,6985,29423,16269,6405,115377
2009-11-11,17103,21329,17749,6980,29365,16498,6398,115422
2009-11-10,17549,21337,17757,6981,29336,16772,6359,116091
2009-11-09,17163,21585,17768,6991,29421,17130,6413,116471
2009-11-05,17079,21392,17770,6998,29415,17100,6435,116189
2009-11-04,17110,21227,17766,7004,29412,17117,6457,116093
2009-11-03,17229,21174,17747,6999,29409,17256,6461,116275
2009-11-02,17277,21341,17754,6994,29394,17433,6482,116675
2009-10-30,16868,21616,17743,6994,29369,17513,6465,116568
2009-10-29,17133,21300,17705,6992,29466,17254,6294,116144
2009-10-28,17195,21144,17691,6980,29428,17125,6251,115814
2009-10-27,17227,21055,17689,6968,29373,16968,6225,115505
2009-10-26,16981,21164,17685,6970,29308,16718,6219,115045
2009-10-23,16899,21131,17684,6969,29261,16554,6256,114754
2009-10-22,17058,21003,17678,6959,29206,16354,6245,114503
2009-10-21,17020,20897,17667,6955,29150,16209,6145,114043
2009-10-20,17316,20967,17660,6946,29133,16093,6165,114280
2009-10-19,17365,21017,17646,6941,29099,15812,6143,114023
2009-10-16,17537,21046,17686,6937,29048,15808,6219,114281
2009-10-15,17806,20985,17679,6934,28997,16198,6206,114805
2009-10-14,17864,20907,17676,6935,28942,16335,6165,114824
2009-10-13,17511,21235,17686,6935,28909,16324,6162,114762
2009-10-09,17301,21212,17691,6953,28944,16496,6152,114749
2009-10-08,17428,21074,17679,6946,28913,16685,6162,114887
2009-10-07,17504,20946,17673,6942,28871,16845,6189,114970
2009-10-06,17636,20892,17671,6945,28841,16907,6215,115107
2009-10-05,17613,20931,17658,6948,28843,16862,6207,115062
2009-10-02,17412,20856,17667,6958,28885,16908,6215,114901
2009-10-01,17716,20809,17661,6952,28876,16777,6198,114989
2009-09-30,17228,21113,17649,6947,28833,16826,6201,114797
2009-09-29,17438,20925,17615,6947,28864,16521,6079,114389
2009-09-28,17362,20894,17613,6941,28877,16312,6058,114057
2009-09-25,17783,20903,17618,6930,28846,16155,6084,114319
2009-09-24,17980,20749,17626,6925,28803,16058,6080,114221
2009-09-23,17930,20614,17635,6918,28747,15842,6107,113793
2009-09-22,17971,20532,17618,7045,28711,15710,5985,113572
2009-09-21,17640,20676,17605,7040,28659,15506,6000,113126
2009-09-18,17682,20709,17611,7050,28613,15402,6036,113103
2009-09-17,18009,20516,17589,7029,28606,15364,6019,113132
2009-09-16,18118,20496,17579,7035,28559,15240,6017,113044
2009-09-15,18055,20547,17575,7029,28486,15139,5986,112817
2009-09-14,18003,20644,17575,7036,28427,15003,5985,112673
2009-09-11,18037,20705,17607,7030,28382,14984,6062,112807
2009-09-10,18198,20563,17613,7011,28314,15216,6107,113022
2009-09-09,18066,20532,17601,7025,28352,15585,6087,113248
2009-09-08,18285,20502,17582,6915,28309,15785,6081,113459
2009-09-07,18410,20575,17580,6908,28278,15863,6122,113736
2009-09-04,18271,20541,17587,6930,28285,15910,6136,113660
2009-09-03,18225,20372,17584,6930,28294,15995,6157,113557
2009-09-02,18009,20225,17579,6919,28257,16204,6131,113324
2009-09-01,18341,20279,17572,6927,28222,16216,6156,113713
2009-08-31,17509,20685,17561,6903,28218,16406,6165,113447
2009-08-28,17725,20516,17522,6886,28328,15865,6034,112876
2009-08-27,17878,20364,17521,6856,28309,15844,6045,112817
2009-08-26,17979,20241,17519,6854,28278,15715,6006,112592
2009-08-25,18320,20271,17490,6859,28237,15367,6031,112575
2009-08-24,18293,20314,17485,6865,28190,15282,6060,112489
2009-08-21,18369,20275,17792,6869,28133,15066,6061,112565
2009-08-20,18474,20237,17783,6873,28089,15016,6065,112537
2009-08-19,18479,20237,18014,6871,28046,14863,6077,112587
2009-08-18,18318,20541,18016,6870,28047,14708,6091,112591
2009-08-14,18013,20582,18060,6884,28051,14660,6171,112421
2009-08-13,18359,20423,18054,6881,28000,14873,6196,112786
2009-08-12,18433,20372,18049,6880,27952,15279,6150,113115
2009-08-11,18389,20358,18043,6886,27902,15406,6166,113150
2009-08-10,18221,20435,18056,6889,27865,15393,6039,112898
2009-08-07,18092,20449,18067,6902,27945,15496,6050,113001
2009-08-06,18133,20212,18067,6898,27940,15578,6039,112867
2009-08-05,17781,20192,18069,6902,27945,15695,6056,112640
2009-08-04,18079,20118,18069,6924,27960,15795,6063,113008
2009-08-03,18120,20209,18066,6917,27920,15720,5914,112866
2009-07-31,17704,20413,18022,6910,27921,15737,5850,112557
2009-07-30,18091,20266,18025,6910,27982,15583,5852,112709
2009-07-29,18091,20193,18005,6903,27988,15358,5832,112370
2009-07-28,18173,20124,18005,6905,27959,15087,5868,112121
2009-07-27,18434,20213,18006,6912,27929,14867,5851,112212
2009-07-24,18551,20209,17999,6917,27899,14701,5859,112135
2009-07-23,18579,20072,17996,6889,27870,14655,5813,111874
2009-07-22,18778,20012,17995,6895,27855,14608,5837,111980
2009-07-21,18753,19975,17993,6896,27826,14608,5848,111899
2009-07-20,18933,20170,17993,6896,27784,14517,5884,112177
2009-07-17,18774,20234,18041,6907,27759,14489,6017,112221
2009-07-16,19125,20148,18030,6902,27729,14727,6023,112684
2009-07-15,18935,20155,18032,6908,27740,15065,6033,112868
2009-07-14,19060,20161,18034,6910,27739,15281,5988,113173
2009-07-13,18882,20409,18049,6924,27723,15345,6007,113339
2009-07-08,18218,20376,18059,6942,27786,15571,6007,112959
2009-07-07,17937,20270,18058,6946,27800,15598,6006,112615
2009-07-06,17854,20225,18058,6961,27796,15693,5989,112576
2009-07-03,18026,20210,18068,6977,27850,15711,5998,112840
2009-07-02,18145,20039,18067,6977,27860,15756,6004,112848
2009-07-01,18373,20075,18071,6998,27872,15694,5929,113012
2009-06-30,17734,20402,18021,6989,27881,16079,5842,112948
2009-06-29,17938,20197,18046,7000,28029,15690,5802,112702
2009-06-26,17870,20147,18049,6966,27995,15664,5740,112431
2009-06-25,18169,19856,18045,6955,28011,15459,5745,112240
2009-06-24,18282,19667,18043,6952,28012,15373,5728,112057
2009-06-23,18183,19655,18038,6943,27997,15303,5735,111854
2009-06-22,18168,19772,18030,6942,27986,15105,5704,111707
2009-06-19,18040,19667,18039,6955,27993,14914,5698,111306
2009-06-18,18466,19477,18032,6958,27965,14783,5701,111382
2009-06-17,18763,19421,18032,6950,27936,14701,5689,111492
2009-06-16,18262,19586,18028,6949,27917,14705,5398,110845
2009-06-12,17859,19547,18068,6960,27903,14699,5481,110517
2009-06-11,17943,19390,18074,6967,27873,14901,5481,110629
2009-06-10,17826,19381,18079,6967,27855,15186,5487,110781
2009-06-09,18024,19338,18091,6978,27904,15130,5474,110939
2009-06-08,18001,19382,18093,6974,27880,15123,5498,110951
2009-06-05,18009,19375,18090,6985,27914,15178,5516,111067
2009-06-04,18172,19248,18091,6998,27946,15321,5452,111228
2009-06-03,18062,19210,18094,6999,27932,15264,5477,111038
2009-06-02,17986,19247,18059,7001,27950,15379,5455,111077
2009-06-01,17979,19565,18061,7008,27960,15438,5451,111462
2009-05-29,17640,19678,18020,7005,28009,15809,5374,111535
2009-05-28,17877,19304,18098,7014,28091,15170,5203,110757
2009-05-27,17951,19242,18096,7009,28085,15096,5213,110692
2009-05-26,17875,19323,18088,7002,28056,14843,5206,110393
2009-05-22,17741,19332,18082,7012,28030,14735,5215,110147
2009-05-21,17565,19309,18082,7011,28016,14580,4859,109422
2009-05-20,17515,19297,18074,7013,28029,14604,4869,109401
2009-05-19,17560,19273,18074,7019,27991,14603,4879,109399
2009-05-18,17680,19351,18114,7022,27953,14475,4973,109568
2009-05-15,17421,19385,18114,7015,27917,14589,4993,109434
2009-05-14,17386,19295,18096,7022,27894,14841,4984,109518
2009-05-13,17328,19323,18097,7018,27869,14909,5038,109582
2009-05-12,17491,19332,18097,7026,27829,15151,4994,109920
2009-05-11,17417,19399,18112,7032,27816,15338,5002,110116
2009-05-08,17004,19397,18116,7046,27887,15424,4974,109848
2009-05-07,16969,19243,18112,7055,27897,15556,4974,109806
2009-05-06,16794,19149,18103,7062,27909,15742,4973,109732
2009-05-05,17002,19157,18104,7067,27926,15875,4963,110094
2009-05-04,17207,19390,18109,7083,27923,15705,4988,110405
2009-04-30,16949,19672,18065,7087,28015,15968,4917,110673
2009-04-29,17166,19537,18112,7091,28099,15429,4970,110404
2009-04-28,17144,19479,18117,7091,28102,15216,5069,110218
2009-04-27,17004,19552,18121,7089,28069,14970,5008,109813
2009-04-24,16992,19502,18126,7098,28031,14842,5021,109612
2009-04-23,16988,19434,18126,7098,28000,14748,5013,109407
2009-04-22,17177,19358,18125,7096,27963,14623,5003,109345
2009-04-21,16909,19378,18120,7094,27923,14569,5016,109009
2009-04-20,16836,19461,18116,7095,27878,14409,5072,108867
2009-04-17,16806,19504,18115,7105,27829,14422,5044,108825
2009-04-16,17093,19438,18119,7106,27753,14427,5038,108974
2009-04-15,17028,19446,18117,7106,27701,14451,5056,108905
2009-04-14,16944,19454,18116,7111,27722,14465,5082,108894
2009-04-13,16586,19694,18115,7120,27684,14496,5014,108709
2009-04-08,16215,19625,18140,7141,27779,14961,5165,109026
2009-04-07,16131,19550,18145,7150,27784,15122,5170,109052
2009-04-06,16237,19563,18150,7154,27780,15220,5176,109280
2009-04-03,16559,19485,18153,7172,27812,15397,5189,109767
2009-04-01,16767,19467,18159,7176,27814,15444,5187,110014
2009-03-31,16386,19571,18107,7169,27811,15743,5140,109927
2009-03-30,16667,19503,18125,7177,27903,15051,5101,109527
2009-03-27,16548,19418,18125,7167,27875,14963,5085,109181
2009-03-26,16824,19290,18162,7168,27860,14854,5044,109202
2009-03-25,16891,19300,18158,7166,27821,14670,5062,109068
2009-03-23,16825,19329,18160,7177,27787,14483,5063,108824
2009-03-20,16473,19336,18155,7181,27723,14322,5046,108236
2009-03-19,16464,19237,18153,7183,27669,14271,5040,108017
2009-03-18,16702,19184,18150,7191,27620,14248,5049,108144
2009-03-17,16837,19152,18183,7187,27566,14227,5122,108274
2009-03-16,16772,19261,18165,7190,27536,14142,5115,108181
2009-03-13,16511,19240,18167,7200,27510,14182,5132,107942
2009-03-12,16662,19071,18163,7205,27522,14328,5124,108075
2009-03-11,16635,18989,18165,7208,27492,14472,5111,108072
2009-03-10,16641,18986,18165,7215,27499,14716,5127,108349
2009-03-09,16625,18930,18179,7237,27567,14755,5119,108412
2009-03-06,16552,18871,18186,7239,27569,14829,5130,108376
2009-03-05,16711,18659,18184,7248,27572,14928,5077,108379
2009-03-04,16859,18658,18185,7261,27587,15118,5105,108773
2009-03-03,16988,18657,18180,7267,27603,15234,5105,109034
2009-03-02,17160,18794,18183,7274,27597,15098,5068,109174
2009-02-27,16638,18838,18127,7283,27592,15447,5014,108939
2009-02-26,16883,18609,18151,7381,27686,15032,4973,108715
2009-02-25,16745,18424,18128,7375,27668,14868,4929,108137
2009-02-24,16850,18287,18138,7376,27650,14737,4936,107974
2009-02-23,16611,18405,18173,7377,27713,14519,4949,107747
2009-02-20,16546,18488,18177,7380,27686,14480,4954,107711
2009-02-19,16417,18371,18176,7388,27712,14414,4936,107414
2009-02-18,16532,18341,18173,7390,27677,14353,4938,107404
2009-02-17,16604,18321,18162,7393,27625,14320,4962,107387
2009-02-16,16515,18487,18155,7395,27590,14222,4962,107326
2009-02-13,16141,18511,18152,7395,27574,14278,4945,106996
2009-02-12,16169,18438,18149,7398,27538,14475,4995,107162
2009-02-11,16290,18343,18145,7400,27508,14712,4986,107384
2009-02-10,16261,18400,18152,7406,27487,14950,5022,107678
2009-02-09,16290,18445,18163,7424,27522,15064,5043,107951
2009-02-06,16066,18482,18167,7434,27602,15215,5046,108012
2009-02-05,16143,18389,18165,7437,27602,15379,5044,108159
2009-02-04,16095,18318,18168,7451,27626,15395,5068,108121
2009-02-03,16204,18345,18170,7455,27637,15682,5100,108593
2009-02-02,16116,18609,18164,7474,27653,15641,5079,108736
2009-01-30,15597,18779,18116,7473,27703,15718,5010,108396
2009-01-29,15742,18524,18120,7487,27736,15482,4951,108042
2009-01-28,15883,18459,18115,7466,27718,15111,4943,107695
2009-01-27,16148,18408,18111,7463,27708,14966,4952,107756
2009-01-26,16224,18589,18103,7461,27693,14922,4990,107982
2009-01-23,16149,18651,18103,7462,27704,14725,5005,107799
2009-01-22,16238,18527,18102,7462,27658,14680,5020,107687
2009-01-21,16171,18586,18095,7462,27625,14683,5002,107624
2009-01-20,16324,18663,18133,7463,27596,14650,5011,107840
2009-01-19,16114,18780,18133,7468,27558,14559,5020,107632
2009-01-16,16196,18915,18129,7473,27566,14568,5050,107897
2009-01-15,16289,18974,18132,7472,27532,14745,5033,108177
2009-01-14,16086,18868,18125,7476,27520,15140,5039,108254
2009-01-13,16238,18913,18128,7476,27497,15309,5052,108613
2009-01-12,15903,19100,18120,7478,27480,15500,5085,108666
2009-01-09,15587,19029,18128,7479,27536,15375,5114,108248
2009-01-08,15593,18898,18107,7479,27513,15452,5106,108148
2009-01-07,15473,18779,18098,7482,27567,15703,5128,108230
2009-01-06,15310,18821,18088,7480,27579,15672,5160,108110
2009-01-05,15398,18906,18083,7481,27599,15767,5146,108380
2009-01-02,15416,19422,18092,7499,27626,15793,5131,108979
2008-12-31,15016,19615,18077,7520,27636,16048,5186,109098
2008-12-30,15335,19594,18051,7587,27685,15451,4959,108662
2008-12-29,15683,19597,18035,7592,27708,15252,4961,108828
2008-12-26,15811,19667,18027,7598,27717,15066,4956,108842
2008-12-24,15821,19687,18025,7607,27717,14916,4941,108714
2008-12-23,16180,19641,18021,7606,27703,14698,4932,108781
2008-12-22,16166,19659,18032,7608,27703,14463,4905,108536
2008-12-19,16175,19590,18013,7615,27699,14319,4895,108306
2008-12-18,15814,19440,17976,7619,27687,14252,4895,107683
2008-12-17,15993,19337,17944,7611,27662,14209,4887,107643
2008-12-16,16121,19309,17932,7613,27635,14177,4879,107666
2008-12-15,15782,19449,17926,7615,27606,14084,4937,107399
2008-12-12,15409,19442,17921,7606,27590,14218,4951,107137
2008-12-11,15560,19340,17897,7606,27564,14547,5051,107565
2008-12-10,15699,19383,17897,7606,27618,14660,5018,107881
2008-12-09,15596,19565,17880,7616,27650,14656,4987,107950
2008-12-05,15445,19517,17798,7625,27658,14753,5013,107809
2008-12-04,15604,19358,17784,7633,27680,14859,5003,107921
2008-12-03,15662,19241,17770,7633,27688,14989,4987,107970
2008-12-02,16005,19295,17760,7633,27702,15125,4967,108487
2008-12-01,15973,19653,17750,7634,27711,14939,4973,108633
2008-11-28,15522,19856,17704,7629,27721,15037,5019,108488
2008-11-27,15838,19615,17696,7618,27738,14555,4854,107914
2008-11-26,15940,19550,17672,7615,27736,14416,4866,107795
2008-11-25,16028,19589,17658,7613,27768,14320,4902,107878
2008-11-24,15877,19844,17522,7586,27755,14168,4921,107673
2008-11-21,15545,19882,17512,7584,27730,14019,4913,107185
2008-11-20,15769,19892,17478,7586,27705,13918,4915,107263
2008-11-19,15667,19880,17482,7581,27675,13906,4763,106954
2008-11-18,16031,19911,17475,7579,27635,13843,4786,107260
2008-11-17,15905,20124,17462,7570,27590,13676,4788,107115
2008-11-14,15777,20166,17442,7569,27574,13752,4789,107069
2008-11-13,15984,20028,17429,7559,27540,13867,4745,107152
2008-11-12,16072,20027,17411,7557,27507,13993,4811,107378
2008-11-11,16354,20007,17390,7550,27477,14165,4827,107770
2008-11-10,16278,20064,17363,7546,27463,14417,4849,107980
2008-11-07,16073,20167,17364,7550,27522,14363,4879,107918
2008-11-05,15953,20077,17339,7535,27539,14534,4880,107857
2008-11-04,16216,20077,17337,7534,27557,14753,4925,108399
2008-11-03,16143,20183,17309,7525,27556,14712,4935,108363
2008-10-31,15603,20332,17226,7503,27546,14751,4971,107932
2008-10-30,15889,20318,17226,7488,27561,14491,4741,107714
2008-10-29,16102,20200,17197,7476,27547,14300,4767,107589
2008-10-28,16457,20154,17182,7470,27515,14205,4767,107750
2008-10-27,16466,20196,17162,7458,27532,14079,4766,107659
2008-10-24,16583,20203,17144,7457,27499,13851,4803,107540
2008-10-23,16444,20063,17120,7448,27454,13834,4820,107183
2008-10-22,16603,19889,17103,7438,27406,13728,4824,106991
2008-10-21,16759,19877,17091,7431,27359,13628,4840,106985
2008-10-20,16969,20005,17075,7420,27332,13467,4794,107062
2008-10-17,16763,20029,17102,7417,27285,13441,4827,106864
2008-10-16,17120,19891,17074,7403,27241,13527,4841,107097
2008-10-15,17176,19943,17037,7388,27179,13745,4891,107359
2008-10-14,16926,20094,17025,7385,27134,13759,4911,107234
2008-10-10,16879,20227,17016,7372,27110,14005,4917,107526
2008-10-09,16801,20078,17004,7371,27100,14066,4925,107345
2008-10-08,16965,19972,16983,7360,27058,14262,4942,107542
2008-10-07,17025,19845,16970,7354,27010,14330,4996,107530
2008-10-06,16971,19834,16961,7347,26981,14284,5015,107393
2008-10-03,16917,19816,16954,7356,27016,14322,5007,107388
2008-10-02,16852,19586,16945,7351,27045,14265,5000,107044
2008-10-01,17025,19623,16924,7343,27014,14173,4956,107058
2008-09-30,16396,19845,16856,7304,26965,14201,4926,106493
2008-09-29,16684,19674,16835,7280,27112,13812,4813,106210
2008-09-26,16960,19547,16820,7265,27097,13574,4805,106068
2008-09-25,17061,19422,16794,7250,27047,13530,4786,105890
2008-09-24,17343,19334,16765,7243,27015,13461,4786,105947
2008-09-23,17518,19316,16747,7221,26968,13352,4789,105911
2008-09-22,17349,19447,16742,7211,26923,13257,4801,105730
2008-09-19,17060,19430,16738,7214,26877,13121,4840,105280
2008-09-18,17209,19310,16761,7203,26833,13011,4832,105159
2008-09-17,17182,19198,16735,7195,26769,12918,4818,104815
2008-09-16,17161,19206,16723,7281,26720,12904,4829,104824
2008-09-15,16908,19238,16698,7265,26658,12848,4836,104451
2008-09-12,16720,19255,16690,7263,26593,12848,4845,104214
2008-09-11,16729,19141,16676,7255,26555,12962,4884,104202
2008-09-10,16538,19103,16656,7249,26488,13265,4867,104166
2008-09-09,16570,19062,16641,7248,26509,13498,4913,104441
2008-09-08,16627,19107,16632,7243,26515,13427,4905,104456
2008-09-05,16562,19119,16622,7240,26627,13491,4823,104484
2008-09-04,16727,18986,16612,7243,26628,13579,4804,104579
2008-09-03,16780,18883,16600,7236,26602,13734,4830,104665
2008-09-02,16924,18873,16589,7232,26581,13878,4859,104936
2008-09-01,16946,19105,16580,7229,26565,13707,4851,104983
2008-08-29,16264,19321,16517,7224,26565,13871,4964,104726
2008-08-28,16675,19079,16519,7228,26670,13436,4725,104332
2008-08-27,16758,18940,16500,7214,26630,13387,4694,104123
2008-08-26,16823,18896,16486,7204,26597,13236,4653,103895
2008-08-25,16649,19025,16473,7184,26555,13073,4671,103630
2008-08-22,16231,18965,16456,7163,26524,12966,4697,103002
2008-08-21,16135,18833,16439,7140,26474,12872,4680,102573
2008-08-20,16234,18858,16421,7139,26426,12851,4675,102604
2008-08-19,16269,18992,16406,7137,26372,12758,4698,102632
2008-08-15,16168,19113,16428,7138,26317,12750,4736,102650
2008-08-14,15938,19002,16409,7134,26284,12910,4735,102412
2008-08-13,16085,18914,16394,7128,26231,13258,4718,102728
2008-08-12,16333,18874,16383,7114,26180,13374,4729,102987
2008-08-11,16013,18945,16364,7110,26139,13352,4774,102697
2008-08-08,15765,19008,16369,7113,26217,13384,4772,102628
2008-08-07,15659,18845,16335,7093,26212,13445,4806,102395
2008-08-06,15578,18801,16338,7088,26197,13588,4803,102393
2008-08-05,15740,18795,16317,7084,26197,13688,4811,102632
2008-08-04,15650,18818,16313,7093,26196,13660,4825,102555
2008-08-01,15841,18841,16321,7079,26185,13668,4856,102791
2008-07-31,15460,19019,16240,7081,26156,13707,4900,102563
2008-07-30,15710,19045,16240,7039,26228,13545,4846,102653
2008-07-29,15871,18965,16240,7023,26262,13466,4761,102588
2008-07-28,15853,19002,16229,7016,26247,13282,4769,102398
2008-07-25,15893,18962,16209,7014,26217,12894,4774,101963
2008-07-24,16170,18764,16181,7003,26219,12805,4776,101918
2008-07-23,16240,18701,16161,6993,26170,12726,4776,101767
2008-07-22,16527,18761,16141,6986,26117,12636,4773,101941
2008-07-21,16311,18910,16123,6979,26067,12497,4795,101682
2008-07-18,16306,18932,16114,6973,26035,12478,4799,101637
2008-07-17,16677,18824,16091,6963,25975,12386,4798,101714
2008-07-16,16914,18818,16069,6952,25927,12352,4811,101843
2008-07-15,16746,18916,16056,6948,25878,12360,4823,101727
2008-07-14,16485,18984,16040,6946,25838,12258,4822,101373
2008-07-11,16444,18992,16031,6943,25985,12333,4855,101583
2008-07-10,16180,18970,16013,6937,25941,12658,4882,101581
2008-07-08,16164,18980,16000,6949,25966,12842,4904,101805
2008-07-07,16096,19010,15982,6947,25959,12895,4859,101748
2008-07-04,15857,18917,15963,6960,25966,13045,4926,101634
2008-07-03,15789,18778,15946,6948,25981,13178,4931,101551
2008-07-02,15825,18616,15932,6938,25982,13291,4943,101527
2008-07-01,16475,18660,15919,6950,25946,13416,4979,102345
2008-06-30,15688,19027,15895,6944,25934,13795,4865,102148
2008-06-27,15776,18855,15873,6929,25960,13322,4863,101578
2008-06-26,16061,18673,15846,6914,25936,13188,4977,101595
2008-06-25,16317,18608,15828,6901,25904,13076,4950,101584
2008-06-24,16379,18633,15806,6894,25876,12917,4931,101436
2008-06-23,16425,18641,15795,6889,25843,12781,4941,101315
2008-06-20,16017,18897,15782,6880,25809,12725,4754,100864
2008-06-19,16319,18845,15801,6873,25757,12682,4829,101106
2008-06-18,16761,18888,15777,6862,25701,12579,4806,101374
2008-06-17,16156,19202,15765,6857,25655,12421,4801,100857
2008-06-13,15861,19212,15755,6853,25626,12387,4822,100516
2008-06-12,15810,19094,15735,6842,25566,12540,4817,100404
2008-06-11,15849,19110,15717,6832,25508,12814,4865,100695
2008-06-10,15883,19145,15706,6819,25457,12976,4927,100913
2008-06-09,15848,19211,15696,6820,25530,12981,4903,100989
2008-06-06,15609,19257,15684,6815,25498,13005,4874,100742
2008-06-05,15550,19155,15661,6809,25433,13084,4809,100501
2008-06-04,15534,19095,15651,6810,25426,13291,4814,100621
2008-06-03,15938,19119,15634,6800,25383,13330,4854,101058
2008-06-02,16161,19430,15627,6788,25377,13156,4875,101414
2008-05-30,15572,19713,15567,6789,25401,13339,4747,101128
2008-05-29,15676,19597,15522,6768,25425,13072,4604,100664
2008-05-28,16069,19488,15499,6734,25401,12878,4586,100655
2008-05-27,16128,19464,15511,6710,25420,12625,4701,100559
2008-05-26,16203,19575,15457,6692,25351,12512,4686,100476
2008-05-23,16077,19659,15484,6687,25508,12324,4630,100369
2008-05-22,16188,19532,15462,6670,25446,12298,4571,100167
2008-05-21,16104,19465,15399,6648,25371,12260,4536,99783
2008-05-20,16187,19513,15386,6633,25363,12187,4504,99773
2008-05-19,16188,19570,15372,6634,25313,12101,4427,99605
2008-05-16,16345,19600,15361,6621,25233,12118,4533,99811
2008-05-15,16339,19614,15364,6594,25149,12157,4521,99738
2008-05-14,16363,19525,15353,6582,25068,12426,4529,99846
2008-05-13,16821,19501,15339,6574,24949,12512,4513,100209
2008-05-12,16545,19538,15333,6569,24994,12592,4479,100050
2008-05-09,16379,19460,15328,6576,24986,12755,4528,100012
2008-05-08,16512,19381,15320,6565,24922,12810,4518,100028
2008-05-07,16088,19304,15310,6553,24838,12987,4527,99607
2008-05-06,16403,19230,15298,6544,24784,13032,4535,99826
2008-05-05,16194,19265,15286,6523,24745,12926,4519,99458
2008-05-02,16333,19398,15282,6542,24717,12937,4513,99722
2008-04-30,15476,19629,15269,6534,24716,13023,4509,99156
2008-04-29,16087,19545,15261,6503,24775,12694,4465,99330
2008-04-28,16060,19543,15235,6481,24713,12531,4424,98987
2008-04-25,16010,19388,15224,6469,24644,12367,4408,98510
2008-04-24,15949,19226,15204,6453,24570,12306,4324,98032
2008-04-23,15911,19092,15185,6438,24493,12237,4316,97672
2008-04-22,15885,19101,15169,6421,24409,12173,4312,97470
2008-04-21,15659,19148,15154,6408,24266,12020,4335,96990
2008-04-18,15309,19130,15138,6400,24198,11928,4348,96451
2008-04-17,15575,19017,15099,6392,24130,11896,4342,96451
2008-04-16,15827,18848,15083,6375,24040,11842,4363,96378
2008-04-15,15741,18899,15073,6364,23969,11782,4366,96194
2008-04-14,15469,18846,15062,6355,23911,11763,4403,95809
2008-04-11,15450,18839,15058,6352,23844,11789,4392,95724
2008-04-10,15234,18765,15048,6339,23798,11997,4398,95579
2008-04-09,15049,18670,15037,6336,23779,12265,4427,95563
2008-04-08,14952,18699,15025,6328,23703,12445,4402,95554
2008-04-07,14835,18672,15019,6328,23638,12453,4405,95350
2008-04-04,14718,18693,14985,6332,23621,12539,4429,95317
2008-04-03,14816,18607,14976,6321,23601,12555,4420,95296
2008-04-01,14907,18614,14967,6319,23562,12440,4448,95257
2008-03-31,14379,18848,14942,6316,23522,12661,4474,95142
2008-03-28,14547,18703,14947,6319,23639,12166,4313,94634
2008-03-27,14744,18508,14920,6288,23643,12059,4306,94468
2008-03-26,14929,18475,14898,6270,23584,11854,4311,94321
2008-03-25,14876,18690,14885,6264,23521,11654,4311,94201
2008-03-19,14628,18593,14921,6267,23559,11618,4325,93911
2008-03-18,15031,18440,14891,6258,23452,11537,4313,93922
2008-03-17,15029,18513,14875,6250,23372,11499,4268,93806
2008-03-14,14824,18421,14864,6248,23302,11457,4241,93357
2008-03-13,14827,18298,14849,6239,23225,11599,4250,93287
2008-03-12,14911,18190,14832,6230,23156,11888,4226,93433
2008-03-11,15141,18181,14822,6224,23089,11991,4236,93684
2008-03-10,15104,18265,14820,6216,23034,12006,4249,93694
2008-03-07,14763,18231,14814,6229,23027,11878,4299,93241
2008-03-06,14669,18123,14797,6221,23002,11995,4269,93076
2008-03-05,14527,18083,14787,6215,22968,12112,4278,92970
2008-03-04,14613,18002,14771,6219,22932,12210,4288,93035
2008-03-03,14850,18091,14761,6212,22882,12100,4314,93210
2008-02-29,14221,18252,14745,6209,23013,12279,4317,93036
2008-02-28,14565,18200,14726,6193,23074,11897,4243,92898
2008-02-27,14450,18100,14696,6172,23020,11782,4188,92408
2008-02-26,14602,18084,14678,6164,22961,11663,4179,92331
2008-02-25,14711,18080,14662,6154,22897,11499,4188,92191
2008-02-22,15042,17931,14652,6146,22844,11424,4266,92305
2008-02-21,15265,17894,14635,6135,22779,11429,4254,92391
2008-02-20,15040,17896,14612,6125,22718,11481,4228,92100
2008-02-19,15021,17868,14597,6122,22714,11460,4223,92005
2008-02-18,15072,17985,14583,6113,22645,11406,4233,92037
2008-02-15,14470,18109,14566,6108,22587,11466,4268,91574
2008-02-14,14809,18036,14549,6103,22597,11555,4301,91950
2008-02-13,14882,17928,14523,6094,22541,11595,4334,91897
2008-02-12,14807,17911,14511,6088,22497,11980,4327,92121
2008-02-11,14663,17972,14510,6085,22434,11948,4319,91931
2008-02-08,14540,17941,14503,6091,22423,11878,4341,91717
2008-02-07,14404,17835,14486,6083,22375,11868,4359,91410
2008-02-06,14387,17772,14466,6070,22323,12057,4383,91458
2008-02-05,14583,17780,14449,6067,22289,12168,4406,91742
2008-02-04,14513,17821,14441,6067,22293,12186,4428,91749
2008-02-01,14813,17885,14431,6072,22258,12086,4463,92008
2008-01-31,14444,18039,14405,6040,22211,12218,4431,91788
2008-01-30,14540,18005,14386,6027,22205,11869,4417,91449
2008-01-29,14818,17990,14366,6016,22276,11685,4339,91490
2008-01-28,14860,18076,14346,6011,22225,11537,4347,91402
2008-01-25,14977,18070,14339,6003,22178,11583,4392,91542
2008-01-24,15300,17996,14321,5994,22124,11563,4390,91688
2008-01-23,15168,17951,14307,5983,22059,11504,4407,91379
2008-01-22,15386,17989,14296,5967,21997,11439,4405,91479
2008-01-21,15164,18178,14287,5958,21945,11332,4427,91291
2008-01-18,14876,18196,14271,5955,21875,11254,4443,90870
2008-01-17,15013,18067,14252,5940,21805,11196,4449,90722
2008-01-16,15228,18076,14239,5929,21738,11136,4472,90818
2008-01-15,15202,18248,14232,5917,21678,11124,4502,90903
2008-01-14,14983,18281,14220,5910,21617,11177,4517,90705
2008-01-11,15126,18303,14212,5906,21566,11225,4524,90862
2008-01-10,15208,18271,14200,5895,21507,11331,4554,90966
2008-01-09,15123,18167,14198,5886,21507,11416,4597,90894
2008-01-08,14993,18143,14188,5881,21440,11503,4580,90728
2008-01-07,14882,18230,14186,5875,21436,11627,4590,90826
2008-01-04,14854,18220,14184,5885,21423,11745,4617,90928
2008-01-03,14624,18266,14176,5879,21393,11694,4620,90652
2008-01-02,14387,18544,14171,5872,21335,11430,4657,90396
2007-12-28,13919,18665,14157,5872,21322,11664,4531,90130
2007-12-27,14920,18377,14124,5860,21340,10994,4499,90114
2007-12-26,15402,18492,14098,5857,21288,10849,4500,90486
2007-12-21,15275,18442,14083,5857,21221,10679,4509,90066
2007-12-20,14976,18314,14044,5849,21214,10602,4495,89494
2007-12-19,14592,18157,14028,5843,21153,10547,4223,88543
2007-12-18,14609,18035,14007,5832,21099,10526,4206,88314
2007-12-17,14259,18132,13993,5822,21027,10428,4147,87808
2007-12-14,13803,18038,13979,5803,20964,10414,4165,87166
2007-12-13,13916,17868,13962,5793,21020,10508,4126,87193
2007-12-12,14070,17818,13944,5776,20959,10743,4117,87427
2007-12-11,13995,17935,13943,5763,20891,10865,4172,87564
2007-12-10,13853,17836,13921,5757,20844,10754,4172,87137
2007-12-07,13709,17814,13919,5761,20866,10723,4187,86979
2007-12-06,13700,17706,13896,5784,20835,10843,4216,86980
2007-12-05,13456,17633,13861,5775,20804,10880,4213,86622
2007-12-04,13704,17634,13847,5774,20793,10953,4241,86946
2007-12-03,13948,17768,13837,5767,20771,10911,4195,87197
2007-11-30,13409,17994,13815,5745,20731,11052,4216,86962
2007-11-29,13751,17682,13794,5729,20748,10773,4107,86584
2007-11-28,13922,17573,13770,5702,20740,10675,4134,86516
2007-11-27,14097,17484,13749,5686,20675,10514,4125,86330
2007-11-26,14157,17557,13708,5672,20625,10359,4124,86202
2007-11-23,14176,17528,13676,5661,20565,10306,4129,86041
2007-11-22,14207,17376,13657,5647,20505,10209,4128,85729
2007-11-21,13959,17352,13646,5638,20448,10173,4127,85343
2007-11-20,13938,17382,13616,5625,20377,10180,4132,85250
2007-11-19,13637,17405,13601,5619,20314,10112,4127,84815
2007-11-16,13818,17415,13585,5611,20480,10118,4095,85122
2007-11-15,14023,17307,13562,5599,20383,10206,4049,85129
2007-11-14,13907,17270,13540,5591,20356,10392,4041,85097
2007-11-13,14037,17218,13533,5586,20279,10562,4079,85294
2007-11-12,13832,17261,13518,5577,20221,10560,4087,85056
2007-11-09,13410,17228,13512,5579,20253,10658,4082,84722
2007-11-08,13479,17092,13487,5572,20194,10762,4078,84664
2007-11-07,13464,17140,13471,5561,20139,10766,4060,84601
2007-11-05,13172,17106,13449,5548,20083,10800,4086,84244
2007-11-02,13015,17099,13445,5540,20082,10761,4129,84071
2007-11-01,13050,17039,13424,5533,20047,10716,4131,83940
2007-10-31,12839,17172,13408,5512,20007,10850,4143,83931
2007-10-30,13269,17144,13388,5484,20001,10427,4084,83797
2007-10-29,13238,17179,13369,5472,19958,10288,4030,83534
2007-10-26,13277,17143,13367,5450,19906,10150,4038,83331
2007-10-25,13454,17012,13334,5438,19851,10110,4033,83232
2007-10-24,13648,16937,13313,5423,19799,10036,4047,83203
2007-10-23,13663,16923,13287,5398,19744,9989,4055,83059
2007-10-22,13536,17015,13281,5386,19683,9790,4080,82771
2007-10-19,13440,16963,13255,5381,19625,9749,4087,82500
2007-10-18,13616,16858,13232,5369,19568,9640,4097,82380
2007-10-17,13639,16859,13223,5357,19504,9582,4094,82258
2007-10-16,13242,17069,13207,5341,19427,9453,4100,81839
2007-10-12,12976,17076,13198,5329,19375,9386,4133,81473
2007-10-11,12962,16964,13165,5316,19306,9447,4163,81323
2007-10-10,12888,16939,13138,5309,19276,9683,4192,81425
2007-10-09,12961,16880,13110,5305,19264,9915,4214,81649
2007-10-08,12835,16922,13070,5296,19218,9965,4207,81513
2007-10-05,12614,16925,13064,5294,19285,10036,4211,81429
2007-10-04,12699,16852,13031,5288,19250,10141,4197,81458
2007-10-03,12515,16751,12997,5273,19205,10181,4195,81117
2007-10-02,12598,16784,12986,5252,19177,10262,4213,81272
2007-10-01,12447,17042,12969,5246,19143,10214,4221,81282
2007-09-28,12375,17120,12950,5240,19089,10107,4174,81055
2007-09-27,12796,16865,12903,5220,19183,9916,4052,80935
2007-09-26,13000,16727,12889,5207,19118,9739,4028,80708
2007-09-25,13197,16692,12875,5189,19054,9650,4003,80660
2007-09-24,13112,16703,12847,5168,18992,9455,3998,80275
2007-09-21,12845,16739,12829,5148,18999,9395,3983,79938
2007-09-20,12852,16718,12799,5134,18934,9342,3987,79766
2007-09-19,12844,16713,12775,5122,18860,9315,3989,79618
2007-09-18,13111,16700,12756,5103,18785,9308,3971,79734
2007-09-17,13005,16831,12732,5093,18714,9147,3953,79475
2007-09-14,12727,16837,12717,5075,18653,9139,3950,79098
2007-09-13,12716,16716,12666,5056,18617,9179,3961,78911
2007-09-12,12905,16590,12634,5040,18539,9368,3953,79029
2007-09-11,13041,16517,12606,5027,18470,9565,3976,79202
2007-09-10,12988,16648,12592,5018,18418,9606,3945,79215
2007-09-07,12835,16585,12571,5027,18409,9670,3969,79066
2007-09-06,12872,16456,12551,5017,18367,9799,3983,79045
2007-09-05,12798,16354,12526,5006,18324,9871,3981,78860
2007-09-04,13003,16316,12509,4989,18291,9942,3978,79028
2007-09-03,13164,16346,12490,4984,18232,9923,4008,79147
2007-08-31,12807,16539,12471,4977,18228,10083,3981,79086
2007-08-30,13123,16487,12441,4964,18236,9795,3961,79007
2007-08-29,13199,16379,12425,4937,18178,9681,3912,78711
2007-08-28,13259,16300,12402,4928,18141,9561,3881,78472
2007-08-27,13162,16323,12379,4914,18082,9420,3873,78153
2007-08-24,13378,16242,12362,4908,18018,9280,3862,78050
2007-08-23,13496,16112,12336,4897,17963,9185,3841,77830
2007-08-22,13635,16013,12317,4883,17907,9050,3864,77669
2007-08-21,13273,16167,12292,4876,17881,8931,3855,77275
2007-08-17,13260,16163,12285,4861,17826,8865,3843,77103
2007-08-16,13321,16073,12260,4850,17758,8787,3860,76909
2007-08-15,13320,16061,12236,4841,17689,8760,3828,76735
2007-08-14,13402,16049,12219,4836,17639,8713,3836,76694
2007-08-13,13238,16077,12197,4820,17571,8633,3840,76376
2007-08-10,12911,16094,12189,4817,17519,8667,3849,76046
2007-08-09,13036,15965,12146,4795,17544,8798,3820,76104
2007-08-08,12985,15900,12105,4778,17493,8981,3857,76099
2007-08-07,13020,15789,12069,4771,17441,9106,3856,76052
2007-08-06,12909,15814,12046,4763,17393,9157,3865,75947
2007-08-03,12975,15808,12036,4765,17439,9192,3841,76056
2007-08-02,13209,15703,12008,4755,17418,9209,3848,76150
2007-08-01,13190,15698,11985,4751,17381,9314,3885,76204
2007-07-31,12958,15735,11959,4742,17237,9436,3943,76010
2007-07-30,13310,15793,11905,4708,17261,9129,3966,76072
2007-07-27,13307,15805,11883,4691,17222,9093,3953,75954
2007-07-26,13663,15718,11862,4676,17170,9028,3958,76075
2007-07-25,13898,15675,11852,4667,17111,8822,3976,76001
2007-07-24,14190,15648,11825,4651,17125,8712,3973,76124
2007-07-23,14010,15670,11805,4640,17078,8621,3794,75618
2007-07-20,13872,15685,11795,4631,17018,8481,3898,75380
2007-07-19,14171,15550,11773,4611,16961,8422,3909,75397
2007-07-18,14282,15486,11752,4583,16905,8391,3844,75243
2007-07-17,14351,15453,11727,4575,16848,8420,3859,75233
2007-07-16,14242,15543,11707,4565,16793,8362,3885,75097
2007-07-13,13900,15520,11693,4558,16800,8379,3844,74694
2007-07-12,13802,15428,11672,4543,16741,8627,3832,74645
2007-07-11,13892,15370,11659,4540,16699,8679,3830,74669
2007-07-10,13514,15526,11654,4536,16672,8641,3853,74396
2007-07-06,12907,15482,11632,4540,16670,8818,3872,73921
2007-07-05,12854,15361,11602,4529,16640,8861,3896,73743
2007-07-04,12808,15253,11590,4533,16619,9079,3886,73768
2007-07-03,12830,15207,11570,4527,16610,9070,3888,73702
2007-07-02,12850,15416,11549,4543,16566,9070,3855,73849
2007-06-29,12343,15441,11538,4544,16566,9238,3824,73494
2007-06-28,12865,15148,11486,4525,16604,9070,3740,73438
2007-06-27,12916,14952,11465,4510,16571,8994,3748,73156
2007-06-26,13051,14839,11439,4488,16522,8915,3733,72987
2007-06-25,13202,14836,11411,4480,16472,8855,3736,72992
2007-06-22,12987,14857,11402,4472,16435,8727,3762,72642
2007-06-21,12910,14766,11380,4459,16395,8636,3826,72372
2007-06-20,12885,14773,11369,4455,16345,8611,3831,72269
2007-06-19,12851,14896,11355,4450,16302,8501,3831,72186
2007-06-15,12903,14951,11336,4445,16252,8520,3858,72265
2007-06-14,12656,14928,11311,4436,16202,8570,3853,71956
2007-06-13,12721,14869,11299,4429,16145,8897,3842,72202
2007-06-12,12503,14903,11285,4418,16097,8963,3824,71993
2007-06-11,12338,14933,11274,4403,16046,8938,3864,71796
2007-06-08,12289,14882,11273,4419,16059,9031,3874,71827
2007-06-07,12322,14797,11256,4412,16022,8952,3910,71671
2007-06-06,12291,14740,11238,4407,15989,9163,3900,71728
2007-06-05,12227,14722,11223,4401,15960,9212,3897,71642
2007-06-04,12226,14705,11224,4402,15956,9156,3923,71592
2007-06-01,12402,14745,11212,4397,15930,9132,3920,71738
2007-05-31,12176,14754,11191,4401,15904,9161,3921,71508
2007-05-30,12617,14880,11174,4384,15873,8926,3629,71483
2007-05-29,12859,14860,11159,4358,15835,8749,3621,71441
2007-05-28,12598,14950,11149,4351,15808,8728,3621,71205
2007-05-24,12575,14920,11138,4346,15767,8571,3627,70944
2007-05-23,12486,14844,11117,4330,15720,8518,3630,70645
2007-05-22,12636,14799,11104,4317,15676,8461,3625,70618
2007-05-21,12480,14878,11088,4310,15625,8371,3629,70381
2007-05-18,12351,14867,11077,4311,15585,8272,3635,70098
2007-05-17,12411,14789,11058,4304,15527,8204,3637,69930
2007-05-16,12553,14736,11047,4296,15528,8170,3663,69993
2007-05-15,12486,14750,11038,4285,15473,8136,3674,69842
2007-05-14,12340,14827,11020,4280,15429,8123,3660,69679
2007-05-11,12322,14825,11014,4276,15392,8176,3576,69581
2007-05-10,12309,14768,11002,4269,15350,8328,3605,69631
2007-05-09,12106,14712,10991,4268,15350,8477,3631,69535
2007-05-08,12011,14722,10980,4263,15302,8546,3628,69452
2007-05-07,11852,14724,10976,4254,15288,8576,3764,69434
2007-05-04,11669,14686,10967,4253,15252,8670,3771,69268
2007-05-03,11795,14585,10948,4248,15214,8717,3816,69323
2007-05-02,11941,14668,10938,4239,15245,8672,3747,69450
2007-04-30,11450,14881,10923,4244,15179,8653,3837,69167
2007-04-27,11685,14791,10919,4229,15271,8523,3789,69207
2007-04-26,11766,14784,10890,4203,15240,8411,3767,69061
2007-04-25,11669,14646,10873,4177,15200,8359,3748,68672
2007-04-24,11768,14604,10856,4090,15147,8268,3737,68470
2007-04-23,11737,14647,10844,4160,15097,8158,3740,68383
2007-04-20,11649,14687,10832,4153,15194,8094,3735,68344
2007-04-19,11615,14616,10811,4152,15158,8170,3738,68260
2007-04-18,11717,14585,10799,4144,15109,8100,3738,68192
2007-04-17,11887,14557,10784,4135,15044,8035,3783,68225
2007-04-16,11750,14665,10774,4129,15008,8104,3758,68188
2007-04-13,11633,14678,10770,4123,15159,8298,3729,68390
2007-04-12,11485,14567,10754,4115,15117,8397,3736,68171
2007-04-11,11542,14518,10741,4109,15071,8401,3772,68154
2007-04-10,11554,14576,10739,4109,15034,8386,3749,68147
2007-04-09,11113,14679,10738,4113,15043,8341,3774,67801
2007-04-04,11069,14699,10740,4119,15050,8313,3814,67804
2007-04-03,10979,14831,10731,4112,15017,8400,3832,67902
2007-03-30,10685,14915,10675,4111,15000,8467,3833,67686
2007-03-29,11079,14678,10688,4097,15031,8365,3750,67688
2007-03-28,11071,14509,10669,4081,14987,8285,3747,67349
2007-03-27,11092,14457,10638,4068,14957,8019,3741,66972
2007-03-26,11233,14499,10622,4059,14907,8018,3748,67086
2007-03-23,11117,14501,10610,4055,14863,7898,3752,66796
2007-03-22,11171,14432,10593,4047,14821,7860,3727,66651
2007-03-21,11248,14388,10579,4041,14779,7801,3727,66563
2007-03-20,11196,14405,10564,4036,14731,7725,3726,66383
2007-03-19,11213,14457,10552,4033,14687,7698,3724,66364
2007-03-16,11169,14459,10538,4019,14639,7751,3750,66325
2007-03-15,11131,14462,10592,4015,14637,7807,3731,66375
2007-03-14,11039,14407,10578,4005,14595,8080,3724,66428
2007-03-13,11129,14381,10567,3989,14542,8186,3711,66505
2007-03-12,11184,14429,10556,3985,14509,8190,3727,66580
2007-03-09,11038,14426,10550,3994,14514,8214,3732,66468
2007-03-08,11058,14332,10534,3986,14479,8188,3736,66313
2007-03-07,10946,14313,10524,3979,14434,8204,3740,66140
2007-03-06,11065,14280,10519,3974,14406,8131,3755,66130
2007-03-05,11014,14312,10511,3970,14409,8170,3750,66136
2007-03-02,11008,14306,10504,3971,14443,8131,3768,66131
2007-03-01,11186,14313,10491,3965,14412,8143,3789,66299
2007-02-28,10990,14399,10469,3955,14375,8158,3824,66170
2007-02-27,11468,14388,10467,3938,14491,7922,3507,66181
2007-02-26,11353,14365,10416,3927,14443,7869,3458,65831
2007-02-23,11273,14356,10411,3923,14415,7753,3439,65570
2007-02-22,11271,14276,10361,3916,14370,7763,3448,65405
2007-02-21,11248,14246,10345,3910,14326,7726,3437,65238
2007-02-20,11201,14234,10335,3905,14283,7728,3449,65135
2007-02-19,11145,14239,10326,3904,14239,7703,3445,65001
2007-02-16,11002,14273,10331,3902,14194,7686,3427,64815
2007-02-15,10943,14272,10318,3891,14145,7811,3415,64795
2007-02-14,10924,14236,10305,3888,14099,7951,3416,64819
2007-02-13,10980,14207,10289,3878,14057,8031,3419,64861
2007-02-12,10884,14268,10286,3873,14023,8110,3427,64871
2007-02-09,10662,14227,10285,3878,14027,8103,3452,64634
2007-02-08,10708,14187,10269,3869,13983,8111,3490,64617
2007-02-07,10787,14153,10262,3862,13928,8197,3508,64697
2007-02-06,10731,14152,10257,3850,13911,8137,3517,64555
2007-02-05,10727,14189,10246,3841,13877,8167,3521,64568
2007-02-02,10771,14196,10241,3843,13867,8163,3550,64631
2007-02-01,10863,14171,10227,3856,13837,8170,3570,64694
2007-01-31,10896,14270,10184,3842,13829,8229,3567,64817
2007-01-30,11223,14294,10185,3848,13835,8052,3511,64948
2007-01-29,11148,14274,10177,3837,13805,7957,3486,64684
2007-01-26,11173,14326,10167,3827,13871,7851,3472,64687
2007-01-25,11279,14295,10156,3817,13816,7812,3438,64613
2007-01-24,11358,14260,10149,3807,13773,7773,3453,64573
2007-01-23,11451,14254,10147,3816,13730,7716,3497,64611
2007-01-22,11424,14371,10131,3807,13686,7630,3511,64560
2007-01-19,11268,14397,10123,3804,13661,7553,3507,64313
2007-01-18,11395,14340,10104,3788,13612,7464,3528,64231
2007-01-17,11292,14255,10090,3778,13566,7455,3560,63996
2007-01-16,11589,14283,10074,3770,13517,7416,3544,64193
2007-01-15,11403,14390,10080,3760,13474,7394,3537,64038
2007-01-12,11148,14440,10078,3751,13441,7433,3543,63834
2007-01-11,11061,14345,10066,3740,13389,7716,3547,63864
2007-01-10,10922,14340,10047,3731,13347,7778,3551,63716
2007-01-09,10881,14323,10039,3728,13346,7801,3554,63672
2007-01-08,11017,14372,10027,3720,13312,7824,3546,63818
2007-01-05,10658,14358,10021,3714,13285,7820,3575,63431
2007-01-04,10740,14277,10014,3714,13276,7874,3497,63392
2007-01-03,10873,14265,10000,3712,13260,7849,3528,63487
2007-01-02,10859,14468,9989,3707,13257,7825,3584,63689
2006-12-29,10580,14517,9974,3710,13062,7658,3619,63120
2006-12-28,11261,14391,9983,3698,13075,7530,3639,63577
2006-12-27,11589,14302,9945,3692,13047,7299,3656,63530
2006-12-26,11680,14297,9923,3686,13045,7298,3645,63574
2006-12-22,11720,14265,9906,3684,13057,7178,3627,63437
2006-12-21,12324,14124,9890,3678,13105,7145,3639,63905
2006-12-20,12448,14020,9880,3673,13136,7056,3584,63797
2006-12-19,12160,13913,9870,3667,13099,7008,3640,63357
2006-12-18,12032,13925,9855,3649,13055,7013,3629,63158
2006-12-15,11975,13930,9842,3640,13008,7012,3650,63057
2006-12-14,11884,13836,9821,3634,13107,7216,3673,63171
2006-12-13,11615,13782,9822,3624,13055,7319,3682,62899
2006-12-12,11762,13756,9801,3620,13000,7302,3637,62878
2006-12-11,11447,13875,9800,3608,12955,7308,3539,62532
2006-12-07,11342,13827,9793,3613,12969,7292,3553,62389
2006-12-06,11490,13730,9778,3608,12932,7362,3544,62444
2006-12-05,11415,13694,9769,3603,12906,7369,3521,62277
2006-12-04,11381,13709,9763,3605,12878,7428,3554,62318
2006-12-01,11425,13745,9759,3603,12860,7367,3583,62342
2006-11-30,10982,13822,9728,3592,12831,7407,3570,61932
2006-11-29,11391,13686,9921,3582,12923,7183,3537,62223
2006-11-28,11379,13628,9909,3562,12881,7100,3554,62013
2006-11-27,11290,13649,9898,3551,12826,7043,3536,61793
2006-11-24,11316,13593,9895,3547,12831,6892,3535,61609
2006-11-23,11311,13546,9885,3537,12783,6855,3554,61471
2006-11-22,11273,13511,9871,3530,12731,6799,3506,61221
2006-11-21,11336,13495,9860,3524,12687,6784,3529,61215
2006-11-20,11402,13544,9843,3518,12626,6700,3544,61177
2006-11-17,11411,13488,9829,3515,12580,6609,3566,60998
2006-11-16,11759,13387,9813,3500,12527,6590,3558,61134
2006-11-15,11540,13404,9801,3493,12480,6572,3556,60846
2006-11-14,11549,13403,9799,3487,12423,6528,3537,60726
2006-11-13,11512,13391,9790,3473,12404,6487,3573,60630
2006-11-10,11395,13394,9785,3470,12358,6501,3582,60485
2006-11-09,11374,13322,9807,3471,12342,6699,3550,60565
2006-11-08,11343,13309,9793,3462,12291,6842,3573,60613
2006-11-07,11204,13363,9784,3457,12266,6933,3581,60588
2006-11-03,10982,13308,9774,3461,12235,6906,3615,60281
2006-11-02,10949,13234,9758,3457,12218,6956,3627,60199
2006-11-01,10948,13207,9741,3453,12181,6966,3646,60142
2006-10-31,10716,13242,9731,3449,12162,7193,3656,60149
2006-10-30,11116,13222,9720,3429,12149,6907,3640,60183
2006-10-27,11107,13203,9710,3418,12122,6865,3674,60099
2006-10-26,11273,13112,9694,3408,12074,6742,3708,60011
2006-10-25,11416,13096,9677,3388,12032,6665,3703,59977
2006-10-24,11441,13084,9663,3382,11981,6595,3715,59861
2006-10-23,11172,13097,9656,3377,11938,6577,3710,59527
2006-10-20,11086,13130,9647,3366,11900,6499,3711,59339
2006-10-19,11035,13076,9636,3367,11862,6478,3701,59155
2006-10-18,11160,13059,9620,3358,11812,6387,3703,59099
2006-10-17,11007,13161,9616,3353,11775,6293,3685,58890
2006-10-13,10836,13153,9591,3350,11732,6246,3688,58596
2006-10-12,10813,13091,9581,3341,11678,6314,3688,58506
2006-10-11,10726,13038,9560,3337,11632,6546,3666,58505
2006-10-10,10800,13081,9558,3330,11587,6608,3659,58623
2006-10-09,10591,13045,9546,3331,11572,6600,3672,58357
2006-10-06,10451,13029,9543,3326,11541,6636,3688,58214
2006-10-05,10505,12964,9531,3321,11515,6694,3705,58235
2006-10-04,10295,12920,9521,3323,11491,6715,3728,57993
2006-10-03,10372,12923,9481,3317,11469,6714,3749,58025
2006-10-02,10473,13028,9463,3309,11446,6684,3764,58167
2006-09-29,10230,13048,9462,3314,11423,6727,3747,57951
2006-09-28,10558,12875,9465,3296,11502,6594,3691,57981
2006-09-27,10523,12828,9439,3278,11461,6507,3687,57723
2006-09-26,10741,12765,9429,3268,11424,6444,3686,57757
2006-09-25,10860,12729,9421,3257,11381,6629,3688,57965
2006-09-22,10785,12696,9411,3252,11326,6272,3690,57432
2006-09-21,10605,12627,9404,3239,11282,6241,3674,57072
2006-09-20,10483,12598,9389,3233,11239,6187,3661,56790
2006-09-19,10473,12586,9378,3226,11163,6197,3678,56701
2006-09-18,10623,12586,9370,3217,11120,6158,3700,56774
2006-09-15,10464,12609,9361,3214,11080,6124,3691,56543
2006-09-14,10535,12585,9350,3203,11033,6149,3691,56546
2006-09-13,10379,12525,9344,3201,10988,6380,3707,56524
2006-09-12,10354,12521,9335,3198,10946,6487,3701,56542
2006-09-11,10362,12564,9403,3194,10911,6450,3712,56596
2006-09-08,10168,12524,9402,3196,10912,6486,3709,56397
2006-09-07,10120,12446,9399,3190,10881,6520,3694,56250
2006-09-06,10107,12396,9387,3182,10865,6584,3682,56203
2006-09-05,10203,12399,9382,3178,10837,6570,3695,56264
2006-09-04,10124,12382,9373,3179,10823,6624,3706,56211
2006-09-01,10165,12381,9367,3179,10799,6643,3696,56230
2006-08-31,9893,12423,9350,3171,10820,6691,3702,56050
2006-08-30,10222,12272,9411,3164,10814,6518,3620,56021
2006-08-29,10453,12215,9403,3142,10800,6430,3640,56083
2006-08-28,10456,12231,9395,3135,10760,6373,3666,56016
2006-08-25,10438,12222,9344,3128,10721,6315,3651,55819
2006-08-24,10561,12175,9331,3120,10675,6234,3645,55741
2006-08-23,10505,12183,9317,3115,10637,6160,3664,55581
2006-08-22,10559,12273,9309,3110,10627,6097,3658,55633
2006-08-18,10285,12221,9276,3109,10594,6021,3665,55171
2006-08-17,10320,12161,9359,3097,10540,5988,3639,55104
2006-08-16,10559,12111,9349,3088,10499,5911,3609,55126
2006-08-15,10501,12138,9341,3079,10468,5890,3608,55025
2006-08-14,10380,12150,9368,3075,10435,5894,3618,54920
2006-08-11,10230,12149,9359,3071,10395,5878,3621,54703
2006-08-10,10142,12055,9346,3065,10370,5887,3602,54467
2006-08-09,10155,12019,9340,3063,10367,6076,3612,54632
2006-08-08,10092,12019,9303,3056,10329,6113,3639,54551
2006-08-07,10107,12036,9290,3052,10305,6170,3606,54566
2006-08-04,10093,12029,9288,3053,10283,6247,3654,54647
2006-08-03,10070,11974,9275,3046,10261,6260,3656,54542
2006-08-02,9995,11941,9264,3042,10243,6272,3642,54399
2006-08-01,10090,11941,9251,3030,10213,6247,3658,54430
2006-07-31,9972,12030,9236,3036,10189,6368,3653,54484
2006-07-28,10185,12008,9233,3022,10230,6203,3686,54567
2006-07-27,10353,11894,9216,3013,10189,6289,3652,54606
2006-07-26,10361,11842,9210,2999,10149,6205,3622,54388
2006-07-25,10609,11834,9197,2993,10116,6125,3641,54515
2006-07-24,10735,11834,9191,2989,10092,6055,3643,54539
2006-07-21,10565,11837,9183,2984,10063,5965,3639,54236
2006-07-20,10677,11819,9165,2978,10013,5926,3626,54204
2006-07-19,10624,11783,9150,2975,9968,5896,3620,54016
2006-07-18,10681,11767,9135,2971,9802,5957,3599,53912
2006-07-17,10577,11778,9126,2965,9766,5944,3608,53764
2006-07-14,10301,11804,9121,2955,9725,5933,3663,53502
2006-07-13,10213,11746,9103,2949,9719,5960,3660,53350
2006-07-12,10026,11727,9094,2943,9686,6235,3680,53391
2006-07-11,9965,11728,9089,2940,9654,6312,3707,53395
2006-07-10,9956,11768,9087,2936,9634,6346,3697,53424
2006-07-07,9556,11742,9084,2939,9649,6359,3681,53010
2006-07-06,9607,11648,9076,2935,9636,6451,3666,53019
2006-07-05,9523,11617,9066,2930,9619,6515,3635,52905
2006-07-04,9648,11628,9065,2932,9610,6465,3643,52991
2006-07-03,9704,11679,9058,2938,9608,6514,3623,53124
2006-06-30,9309,11741,9037,3014,9561,6670,3646,52978
2006-06-29,9776,11685,9038,3018,9617,6561,3585,53280
2006-06-28,9837,11555,9034,2997,9593,6526,3529,53071
2006-06-27,9955,11473,9030,2990,9598,6510,3515,53071
2006-06-26,10036,11463,9025,2973,9566,6473,3528,53064
2006-06-23,9821,11533,9030,2968,9538,6434,3527,52851
2006-06-22,9823,11508,9021,2952,9510,6372,3513,52699
2006-06-21,9786,11488,9010,2947,9458,6318,3486,52493
2006-06-20,9760,11506,9008,2940,9462,6250,3470,52396
2006-06-16,9810,11495,8991,2939,9424,6220,3469,52348
2006-06-15,10020,11523,8987,2933,9396,6232,3456,52547
2006-06-14,9700,11453,8976,2929,9366,6477,3461,52362
2006-06-13,9577,11420,8967,2921,9318,6508,3424,52135
2006-06-12,9317,11464,8962,2917,9311,6516,3426,51913
2006-06-09,9089,11440,8956,2916,9298,6534,3431,51664
2006-06-08,9059,11382,8940,2911,9262,6593,3456,51603
2006-06-07,8917,11367,8932,2904,9231,6606,3470,51427
2006-06-06,8966,11340,8918,2898,9204,6553,3487,51366
2006-06-05,8919,11344,8916,2894,9194,6579,3485,51331
2006-06-02,8859,11340,8914,2897,9180,6578,3538,51306
2006-06-01,8944,11293,8906,2889,9158,6541,3527,51258
2006-05-31,8747,11327,8898,2885,9165,6655,3541,51218
2006-05-30,9187,11296,8889,2878,9187,6418,3531,51386
2006-05-29,9104,11306,8881,2858,9164,6364,3521,51198
2006-05-26,9050,11319,8887,2853,9129,6253,3532,51023
2006-05-24,9133,11269,8884,2847,9102,6222,3516,50973
2006-05-23,8983,11254,8872,2839,9067,6113,3515,50643
2006-05-22,8939,11296,8867,2832,9026,6028,3506,50494
2006-05-19,8747,11290,8871,2826,9090,5982,3500,50306
2006-05-18,8951,11221,8865,2818,9060,5947,3491,50353
2006-05-17,8992,11196,8861,2809,9027,5951,3504,50340
2006-05-16,9050,11227,8856,2798,8990,5947,3587,50455
2006-05-15,8953,11263,8860,2791,8957,5899,3572,50295
2006-05-12,8702,11283,8859,2788,8917,5896,3583,50028
2006-05-11,8583,11256,8853,2779,8885,5974,3615,49945
2006-05-10,8502,11251,8854,2772,8860,6130,3632,50001
2006-05-09,8358,11221,8855,2772,8853,6157,3636,49852
2006-05-08,8272,11228,8851,2765,8828,6148,3592,49684
2006-05-05,8224,11229,8856,2764,8799,6174,3624,49670
2006-05-04,8320,11177,8851,2764,8785,6226,3609,49732
2006-05-03,8358,11223,8843,2761,8768,6185,3530,49668
2006-05-02,8226,11351,8839,2759,8740,6173,3554,49642
2006-04-28,7993,11396,8826,2832,8752,6263,3525,49587
2006-04-27,8281,11299,8891,2747,8776,5952,3566,49512
2006-04-26,8344,11269,8881,2722,8754,5841,3559,49370
2006-04-25,8435,11248,8879,2785,8719,5809,3568,49443
2006-04-24,8528,11268,8880,2774,8684,5723,3556,49413
2006-04-21,8376,11286,8872,2693,8689,5679,3533,49128
2006-04-20,8273,11281,8863,2686,8659,5671,3545,48978
2006-04-19,8246,11251,8860,2680,8662,5687,3552,48938
2006-04-18,8383,11249,8853,2676,8634,5590,3555,48940
2006-04-17,8481,11343,8848,2738,8600,5618,3558,49186
2006-04-12,8283,11332,8851,2735,8561,5717,3560,49039
2006-04-11,8241,11269,8844,2664,8533,5872,3563,48986
2006-04-10,8123,11294,8842,2658,8512,5896,3517,48842
2006-04-07,8009,11254,8838,2656,8507,5927,3497,48688
2006-04-06,8041,11121,8789,2654,8484,5938,3498,48525
2006-04-05,8005,11090,8789,2647,8466,5985,3549,48531
2006-04-04,8034,11124,8796,2650,8456,5969,3591,48620
2006-04-03,8303,11138,8764,2645,8433,6014,3595,48892
2006-03-31,8010,11135,8734,2633,8396,6033,3601,48542
2006-03-30,8195,11103,8745,2633,8423,5967,3582,48648
2006-03-29,8271,11048,8708,2618,8399,5849,3580,48473
2006-03-28,8383,11026,8729,2608,8374,5756,3599,48475
2006-03-27,8514,11078,8718,2602,8344,5698,3593,48547
2006-03-23,8554,11067,8715,2599,8315,5606,3600,48456
2006-03-22,8457,11020,8709,2591,8289,5590,3540,48196
2006-03-21,8299,11006,8708,2584,8272,5601,3522,47992
2006-03-20,8295,11023,8745,2580,8236,5579,3561,48019
2006-03-17,8231,11010,8742,2578,8208,5575,3564,47908
2006-03-16,8398,11002,8732,2570,8217,5604,3546,48069
2006-03-15,8660,11040,8732,2564,8181,5674,3536,48387
2006-03-14,8325,11030,8738,2559,8155,5824,3531,48162
2006-03-13,8258,11058,8733,2554,8130,5871,3534,48138
2006-03-10,8089,11052,8738,2558,8110,5856,3547,47950
2006-03-09,8254,10998,8741,2560,8097,5873,3568,48091
2006-03-08,8258,10970,8735,2555,8070,5897,3553,48038
2006-03-07,8433,10938,8722,2550,8048,5921,3573,48185
2006-03-06,8529,10955,8723,2545,8032,5945,3581,48310
2006-03-03,8547,10974,8728,2546,8025,5918,3581,48319
2006-03-02,8721,10921,8725,2543,8012,5889,3601,48412
2006-03-01,9000,10923,8721,2534,8003,5822,3615,48618
2006-02-28,8795,10979,8737,2536,7969,5956,3604,48576
2006-02-27,8703,10966,8747,2526,7985,5729,3596,48252
2006-02-24,8707,10961,8747,2525,7966,5665,3594,48165
2006-02-23,8667,10914,8742,2520,7941,5611,3588,47983
2006-02-22,8784,10871,8741,2511,7943,5589,3588,48027
2006-02-21,8563,10848,8736,2506,7921,5548,3579,47701
2006-02-20,8553,10881,8730,2505,7895,5539,3586,47689
2006-02-17,8507,10907,8728,2498,7873,5470,3580,47563
2006-02-16,8710,10875,8721,2493,7841,5484,3583,47707
2006-02-15,8704,10897,8716,2489,7809,5446,3572,47633
2006-02-14,8441,10907,8707,2483,7841,5452,3555,47386
2006-02-13,8370,10922,8704,2480,7812,5409,3557,47254
2006-02-10,8208,10914,8703,2478,7796,5411,3568,47078
2006-02-09,8198,10885,8700,2478,7794,5461,3544,47060
2006-02-08,8219,10858,8695,2471,7767,5654,3524,47188
2006-02-07,8220,10851,8697,2468,7745,5665,3512,47158
2006-02-06,8058,10877,8697,2463,7729,5683,3477,46984
2006-02-03,8135,10879,8694,2463,7821,5709,3508,47209
2006-02-02,8073,10862,8688,2460,7810,5762,3510,47165
2006-02-01,8186,10861,8711,2457,7779,5794,3521,47309
2006-01-31,7985,10924,8698,2451,7759,5903,3535,47255
2006-01-30,8254,10886,8703,2457,7819,5696,3485,47300
2006-01-27,8246,10891,8700,2450,7808,5647,3497,47239
2006-01-26,8313,10861,8685,2443,7789,5605,3485,47181
2006-01-25,8510,10836,8687,2440,7758,5541,3491,47263
2006-01-24,8550,10791,8681,2432,7723,5506,3437,47120
2006-01-23,8428,10812,8672,2416,7701,5432,3452,46913
2006-01-20,8307,10856,8671,2410,7675,5348,3448,46715
2006-01-19,8586,10888,8661,2411,7655,5324,3485,47010
2006-01-18,8694,10878,8657,2407,7635,5292,3477,47040
2006-01-17,8962,10876,8654,2407,7608,5334,3476,47317
2006-01-16,8615,10938,8655,2400,7584,5301,3478,46971
2006-01-13,8335,10966,8665,2388,7569,5304,3493,46720
2006-01-12,8272,10936,8655,2379,7535,5371,3501,46649
2006-01-11,8281,10916,8656,2373,7510,5499,3501,46736
2006-01-10,8286,10933,8651,2364,7460,5540,3525,46759
2006-01-09,8086,10967,8651,2358,7463,5533,3526,46584
2006-01-06,7940,10947,8650,2353,7434,5581,3557,46462
2006-01-05,8026,10911,8644,2346,7417,5584,3545,46473
2006-01-04,8002,10883,8641,2343,7409,5582,3569,46429
2006-01-03,7995,10842,8640,2337,7392,5553,3594,46353
2006-01-02,8077,10907,8635,2333,7375,5518,3594,46439
2005-12-30,7763,11017,8626,2320,7382,5553,3579,46240
2005-12-29,8217,10866,8669,2318,7366,5444,3614,46494
2005-12-28,8453,10749,8650,2314,7343,5358,3657,46524
2005-12-27,8686,10580,8635,2308,7317,5294,3658,46478
2005-12-26,8779,10542,8611,2308,7290,5224,3645,46399
2005-12-23,8803,10507,8610,2305,7271,5097,3624,46217
2005-12-22,9067,10499,8655,2303,7245,5037,3627,46433
2005-12-21,8957,10360,8642,2298,7219,4982,3591,46049
2005-12-20,9150,10281,8619,2291,7194,4935,3613,46083
2005-12-19,8853,10258,8634,2296,7165,4886,3605,45697
2005-12-16,8791,10236,8626,2293,7150,4888,3616,45600
2005-12-15,8769,10198,8612,2287,7120,5069,3700,45755
2005-12-14,8745,10163,8606,2290,7103,5114,3746,45767
2005-12-13,8505,10160,8602,2284,7074,5123,3807,45555
2005-12-12,8408,10116,8611,2278,7057,5069,3796,45335
2005-12-09,8310,10154,8609,2276,7032,5085,3637,45103
2005-12-07,8164,10072,8598,2273,7016,5124,3546,44793
2005-12-06,8254,10074,8574,2261,7018,5117,3449,44747
2005-12-05,8102,10071,8563,2260,6998,5048,3451,44493
2005-12-02,8133,10063,8564,2258,6995,5077,3473,44563
2005-12-01,8209,10023,8551,2249,6975,5091,3461,44559
2005-11-30,7953,10006,8554,2246,6972,5105,3422,44258
2005-11-29,8442,9959,8532,2236,7026,4950,3390,44535
2005-11-28,8566,9914,8586,2232,7008,4894,3366,44566
2005-11-25,8503,9927,8581,2227,6979,4792,3373,44382
2005-11-24,8734,9868,8672,2221,6955,4718,3397,44565
2005-11-23,8576,9814,8673,2217,6917,4713,3387,44297
2005-11-22,8688,9791,8661,2214,6888,4670,3373,44285
2005-11-21,8532,9800,8663,2211,6867,4608,3389,44070
2005-11-18,8553,9717,8662,2204,6942,4558,3379,44015
2005-11-17,8717,9685,8563,2200,6911,4532,3348,43956
2005-11-16,8780,9640,8560,2194,6880,4512,3350,43916
2005-11-15,8775,9645,8552,2187,6851,4476,3346,43832
2005-11-14,8664,9638,8546,2182,6825,4461,3323,43639
2005-11-11,8478,9612,8595,2176,6799,4437,3341,43438
2005-11-10,8308,9597,8592,2170,6774,4469,3360,43270
2005-11-09,8174,9555,8586,2181,6763,4645,3351,43255
2005-11-08,8091,9532,8587,2176,6733,4700,3359,43178
2005-11-07,8111,9525,8586,2169,6709,4722,3356,43178
2005-11-04,8057,9499,8519,2169,6698,4734,3357,43033
2005-11-03,8125,9478,8512,2163,6669,4723,3382,43052
2005-11-02,8019,9436,8506,2157,6663,4718,3382,42881
2005-11-01,8061,9429,8497,2154,6674,4721,3359,42895
2005-10-31,7900,9485,8495,2135,6681,4817,3369,42882
2005-10-28,8207,9434,8502,2139,6682,4640,3320,42924
2005-10-27,8090,9329,8494,2128,6672,4565,3330,42608
2005-10-26,8330,9262,8490,2121,6638,4512,3309,42662
2005-10-25,8413,9231,8490,2117,6611,4470,3321,42653
2005-10-24,8147,9231,8495,2112,6588,4388,3355,42316
2005-10-21,8114,9234,8489,2110,6558,4303,3343,42151
2005-10-20,8167,9210,8480,2104,6534,4261,3353,42109
2005-10-19,8117,9182,8473,2100,6506,4281,3342,42001
2005-10-18,8177,9151,8476,2090,6478,4232,3396,42000
2005-10-17,8066,9173,8468,2090,6459,4193,3420,41869
2005-10-14,7877,9201,8466,2083,6425,4230,3410,41692
2005-10-13,7860,9140,8460,2079,6393,4333,3411,41676
2005-10-12,7907,9139,8450,2074,6370,4358,3387,41685
2005-10-11,7737,9199,8449,2069,6355,4321,3390,41520
2005-10-07,7683,9209,8582,2070,6335,4369,3404,41652
2005-10-06,7618,9163,8565,2064,6318,4384,3428,41540
2005-10-05,7523,9139,8548,2061,6460,4283,3444,41458
2005-10-04,7495,9124,8542,2056,6478,4280,3409,41384
2005-10-03,7592,9084,8539,2052,6456,4242,3477,41442
2005-09-30,7347,9177,8490,2054,6449,4354,3427,41298
2005-09-29,7675,8994,8530,2041,6460,4208,3427,41335
2005-09-28,7899,8922,8540,2035,6446,4154,3413,41409
2005-09-27,7964,8860,8534,2033,6424,4104,3506,41425
2005-09-26,7976,8842,8547,2026,6401,4058,3480,41330
2005-09-23,7775,8732,8554,2026,6366,3994,3517,40964
2005-09-22,7877,8685,8553,2021,6350,3980,3527,40993
2005-09-21,7885,8643,8555,2019,6330,3959,3529,40920
2005-09-20,7829,8629,8558,2013,6337,3913,3499,40778
2005-09-19,7807,8576,8565,2010,6314,3902,3479,40653
2005-09-16,7778,8556,8560,2011,6294,3904,3484,40587
2005-09-15,7728,8538,8569,2005,6268,3934,3509,40551
2005-09-14,7583,8518,8599,1998,6237,4110,3508,40553
2005-09-13,7523,8496,8596,1992,6213,4148,3515,40483
2005-09-12,7394,8500,8604,1987,6196,4101,3489,40271
2005-09-09,7296,8479,8598,1987,6173,4134,3492,40159
2005-09-08,7271,8440,8592,1983,6154,4137,3507,40084
2005-09-07,7316,8409,8590,1978,6135,4157,3497,40082
2005-09-06,7357,8387,8593,1972,6120,4186,3528,40143
2005-09-05,7373,8377,8599,1975,6107,4130,3506,40067
2005-09-02,7336,8364,8589,1962,6096,4166,3526,40039
2005-09-01,7438,8324,8586,1957,6080,4131,3530,40046
2005-08-31,7296,8343,8564,2010,6063,4261,3546,40083
2005-08-30,7622,8345,8567,2006,6131,4039,3566,40276
2005-08-29,7666,8324,8562,1988,6113,4006,3549,40208
2005-08-26,7687,8315,8648,1994,6084,3948,3562,40238
2005-08-25,7836,8267,8645,1989,6061,3899,3548,40245
2005-08-24,7818,8220,8648,1983,6034,3873,3543,40119
2005-08-23,7854,8152,8637,1978,6012,3827,3544,40004
2005-08-22,7967,8161,8633,1973,5995,3782,3556,40067
2005-08-19,7802,8166,8633,1974,5960,3815,3551,39901
2005-08-18,7813,8133,8624,1969,5943,3774,3541,39797
2005-08-17,7730,8052,8622,1963,5917,3745,3562,39591
2005-08-16,7625,8110,8619,1959,5900,3712,3515,39440
2005-08-12,7387,8128,8621,1958,5880,3685,3522,39181
2005-08-11,7429,8105,8600,1953,5867,3703,3531,39188
2005-08-10,7415,8104,8597,1948,5850,3833,3486,39233
2005-08-09,7607,8081,8596,1948,5833,3889,3481,39435
2005-08-08,7465,8078,8591,1944,5817,3884,3489,39268
2005-08-05,7426,8091,8590,1942,5789,3916,3483,39237
2005-08-04,7461,8049,8582,1941,5783,3947,3494,39257
2005-08-03,7408,8021,8577,1938,5765,3883,3485,39077
2005-08-02,7521,8002,8578,1935,5764,3957,3498,39255
2005-08-01,7485,8026,8574,1937,5742,3905,3487,39156
2005-07-29,7360,8019,8561,1935,5764,4033,3503,39175
2005-07-28,7610,7956,8568,1929,5755,3889,3490,39197
2005-07-27,7615,7947,8577,1936,5808,3845,3498,39226
2005-07-26,7919,7940,8583,1933,5789,3793,3496,39453
2005-07-25,7798,7923,8581,1930,5767,3731,3500,39230
2005-07-22,7705,7922,8579,1922,5729,3687,3495,39039
2005-07-21,7548,7919,8651,1918,5720,3666,3502,38924
2005-07-20,7547,7901,8645,1917,5698,3639,3490,38837
2005-07-19,7565,7893,8641,1913,5678,3652,3490,38832
2005-07-18,7579,7892,8641,1910,5658,3608,3480,38768
2005-07-15,7571,7956,8640,1908,5643,3597,3488,38803
2005-07-14,7570,7935,8639,1920,5627,3624,3503,38818
2005-07-13,7542,7934,8638,1915,5605,3706,3489,38829
2005-07-12,7493,7922,8634,1911,5587,3841,3486,38874
2005-07-11,7525,7937,8634,1908,5591,3865,3485,38945
2005-07-08,7332,7936,8635,1909,5583,3866,3489,38750
2005-07-07,7371,7953,8628,1923,5575,3902,3483,38835
2005-07-06,7380,7914,8629,1919,5565,3926,3474,38807
2005-07-05,7447,7896,8627,1917,5558,3906,3490,38841
2005-07-04,7448,7869,8624,1916,5555,3934,3467,38813
2005-07-01,7370,7889,8624,1920,5535,3942,3473,38753
2005-06-30,7113,7859,8614,1916,5531,4079,3539,38651
2005-06-29,7438,7808,8664,1894,5545,3902,3708,38959
2005-06-28,7373,7816,8660,1878,5529,3881,3696,38833
2005-06-27,7493,7785,8699,1876,5517,3814,3695,38879
2005-06-24,7438,7785,8687,1874,5495,3761,3686,38726
2005-06-23,7408,7698,8686,1867,5538,3697,3662,38556
2005-06-22,7382,7681,8682,1862,5517,3692,3648,38464
2005-06-21,7233,7631,8680,1929,5501,3620,3651,38245
2005-06-17,7317,7636,8680,1926,5475,3583,3675,38292
2005-06-16,7467,7604,8668,1920,5456,3547,3660,38322
2005-06-15,7573,7591,8663,1917,5439,3522,3700,38405
2005-06-14,7412,7607,8664,1918,5421,3465,3691,38178
2005-06-13,7204,7615,8664,1913,5405,3443,3698,37942
2005-06-10,7000,7618,8667,1911,5382,3454,3701,37733
2005-06-09,6875,7603,8665,1909,5375,3459,3704,37590
2005-06-08,6859,7601,8661,1905,5363,3547,3660,37596
2005-06-07,6800,7589,8656,1905,5347,3665,3579,37541
2005-06-06,6867,7593,8651,1901,5331,3675,3588,37606
2005-06-03,6688,7571,8652,1901,5307,3681,3580,37380
2005-06-02,6782,7562,8640,1899,5300,3714,3596,37493
2005-06-01,6851,7540,8639,1900,5308,3779,3580,37597
2005-05-31,6648,7566,8620,1890,5440,3908,3564,37636
2005-05-30,6826,7550,8682,1891,5465,3653,3549,37616
2005-05-27,6831,7541,8677,1880,5446,3664,3580,37619
2005-05-26,6883,7524,8680,1873,5435,3593,3600,37588
2005-05-24,6991,7531,8678,1869,5424,3542,3620,37655
2005-05-23,6902,7520,8735,1865,5404,3475,3616,37517
2005-05-20,6702,7544,8733,1861,5442,3429,3630,37341
2005-05-19,6773,7510,8730,1887,5421,3442,3637,37400
2005-05-18,6740,7519,8726,1881,5410,3425,3657,37358
2005-05-17,6936,7379,8722,1877,5387,3387,3623,37311
2005-05-16,6946,7408,8724,1873,5364,3390,3615,37320
2005-05-13,6783,7378,8729,1870,5340,3467,3625,37192
2005-05-12,6573,7331,8721,1865,5321,3474,3624,36909
2005-05-11,6521,7345,8721,1861,5309,3515,3626,36898
2005-05-10,6428,7333,8725,1870,5296,3556,3640,36848
2005-05-09,6503,7351,8728,1868,5296,3579,3649,36974
2005-05-06,6420,7317,8732,1864,5268,3598,3628,36827
2005-05-05,6497,7298,8732,1854,5254,3644,3619,36898
2005-05-04,6464,7191,8720,1851,5246,3623,3703,36798
2005-05-03,6558,7173,8721,1847,5241,3619,3721,36880
2005-05-02,6697,7223,8724,1840,5224,3615,3723,37046
2005-04-29,6558,7234,8716,1839,5204,3725,3703,36979
2005-04-28,6689,7107,8725,1830,5173,3580,3684,36788
2005-04-27,6677,7073,8726,1825,5160,3518,3671,36650
2005-04-26,6765,7014,8725,1820,5145,3443,3691,36603
2005-04-25,6793,7040,8728,1817,5118,3413,3609,36518
2005-04-22,6656,7051,8727,1813,5099,3381,3617,36344
2005-04-21,6533,7030,8722,1810,5079,3345,3592,36111
2005-04-20,6567,7073,8727,1809,5070,3326,3611,36183
2005-04-19,6553,7054,8725,1806,5052,3337,3621,36148
2005-04-18,6531,7023,8680,1803,5099,3312,3578,36026
2005-04-15,6456,7030,8653,1798,5078,3308,3571,35894
2005-04-14,6431,6985,8650,1794,5057,3326,3571,35814
2005-04-13,6379,6976,8654,1789,5041,3482,3576,35897
2005-04-12,6400,6984,8657,1786,5024,3554,3579,35984
2005-04-11,6359,6990,8662,1783,5014,3535,3557,35900
2005-04-08,6281,6992,8664,1782,5004,3551,3564,35838
2005-04-07,6312,6952,8667,1777,5014,3573,3572,35867
2005-04-06,6241,6940,8673,1773,5002,3626,3523,35778
2005-04-05,6255,6940,8676,1771,4994,3612,3519,35767
2005-04-04,6272,6907,8675,1769,4989,3604,3525,35741
2005-04-01,6221,6932,8675,1772,4975,3596,3521,35692
2005-03-31,6127,6944,8674,1762,4960,3686,3548,35701
2005-03-30,6290,6875,8663,1753,4974,3518,3516,35589
2005-03-29,6471,6848,8666,1750,4956,3482,3534,35707
2005-03-28,6494,6874,8669,1746,4940,3419,3414,35556
2005-03-23,6478,6884,8675,1743,4897,3387,3437,35501
2005-03-22,6451,6847,8669,1740,4881,3366,3427,35381
2005-03-21,6524,6839,8668,1737,4861,3352,3408,35389
2005-03-18,6428,6816,8665,1736,4837,3347,3440,35269
2005-03-17,6431,6792,8666,1731,4823,3390,3426,35259
2005-03-16,6376,6782,8678,1729,4800,3458,3338,35161
2005-03-15,6376,6775,8678,1725,4785,3570,3352,35261
2005-03-14,6245,6818,8677,1723,4769,3548,3359,35139
2005-03-11,6285,6804,8681,1721,4746,3579,3352,35168
2005-03-10,6171,6772,8683,1716,4730,3576,3350,34998
2005-03-09,6137,6762,8688,1713,4718,3541,3357,34916
2005-03-08,6099,6761,8694,1739,4707,3554,3362,34916
2005-03-07,6124,6762,8692,1743,4698,3556,3344,34919
2005-03-04,6170,6772,8694,1743,4679,3501,3343,34902
2005-03-03,6223,6741,8695,1741,4672,3487,3345,34904
2005-03-02,6232,6726,8694,1739,4665,3484,3366,34906
2005-03-01,6297,6742,8755,1734,4651,3465,3373,35017
2005-02-28,6192,6725,8753,1738,4688,3500,3401,34997
2005-02-25,6336,6750,8760,1734,4681,3316,3400,34977
2005-02-24,6489,6724,8759,1730,4668,3320,3419,35109
2005-02-23,6396,6707,8759,1726,4659,3297,3414,34958
2005-02-22,6374,6692,8759,1723,4650,3287,3419,34904
2005-02-21,6343,6692,8757,1718,4625,3242,3438,34815
2005-02-18,6196,6710,8780,1717,4605,3236,3450,34694
2005-02-17,6252,6692,8778,1714,4621,3208,3463,34728
2005-02-16,6348,6694,8777,1711,4604,3187,3463,34784
2005-02-15,6419,6721,8777,1710,4589,3175,3465,34856
2005-02-14,6348,6735,8781,1708,4578,3173,3483,34806
2005-02-11,6272,6744,8782,1705,4609,3189,3457,34758
2005-02-10,6292,6732,8767,1703,4594,3201,3468,34757
2005-02-09,6225,6725,8764,1701,4584,3300,3477,34776
2005-02-08,6242,6710,8759,1699,4571,3385,3471,34837
2005-02-07,6211,6735,8760,1697,4559,3429,3488,34879
2005-02-04,6172,6739,8768,1698,4542,3446,3471,34836
2005-02-03,6253,6800,8766,1695,4536,3462,3474,34986
2005-02-02,6198,6797,8767,1694,4529,3448,3479,34912
2005-02-01,6307,6796,8767,1692,4543,3404,3479,34988
2005-01-31,6180,6801,8782,1693,4533,3491,3512,34992
2005-01-28,6269,6842,8794,1710,4579,3357,3445,34996
2005-01-27,6357,6801,8789,1705,4566,3334,3445,34997
2005-01-26,6363,6787,8785,1699,4563,3290,3450,34937
2005-01-25,6488,6790,8786,1699,4566,3247,3459,35035
2005-01-24,6459,6798,8781,1694,4531,3202,3468,34933
2005-01-21,6432,6719,8786,1690,4530,3142,3468,34767
2005-01-20,6488,6717,8786,1686,4515,3120,3478,34790
2005-01-19,6470,6687,8787,1683,4494,3138,3463,34722
2005-01-18,6400,6687,8790,1679,4473,3077,3464,34570
2005-01-17,6361,6709,8801,1677,4467,3056,3459,34530
2005-01-14,6131,6703,8791,1676,4457,3076,3477,34311
2005-01-13,6083,6692,8792,1673,4434,3125,3479,34278
2005-01-12,6006,6681,8794,1667,4406,3095,3479,34128
2005-01-11,5916,6661,8791,1663,4393,3244,3489,34157
2005-01-10,5924,6655,8795,1658,4384,3224,3503,34143
2005-01-07,5862,6639,8663,1658,4370,3252,3486,33930
2005-01-06,5802,6667,8668,1654,4360,3297,3512,33960
2005-01-05,5796,6664,8670,1652,4338,3258,3502,33880
2005-01-04,5808,6689,8675,1650,4330,3252,3533,33937
2005-01-03,5587,6834,8677,1652,4322,3221,3567,33860
2004-12-31,5452,6824,8698,1657,4251,3362,3562,33806
2004-12-30,5708,6884,8696,1653,4261,3215,3533,33950
2004-12-29,5995,6852,8699,1658,4285,3149,3537,34175
2004-12-28,6248,6816,8697,1654,4278,3118,3557,34368
2004-12-27,6333,6825,8695,1651,4263,3089,3599,34455
2004-12-24,6379,6786,8696,1651,4253,3042,3591,34398
2004-12-23,6549,6760,8697,1645,4234,2985,3595,34465
2004-12-22,6535,6696,8695,1640,4223,2960,3599,34348
2004-12-21,6591,6666,8696,1635,4207,2946,3564,34305
2004-12-20,6467,6630,8695,1634,4189,2917,3533,34065
2004-12-17,6494,6670,8693,1630,4205,2963,3549,34204
2004-12-16,6456,6651,8691,1630,4206,2990,3564,34188
2004-12-15,6501,6639,8688,1628,4189,3015,3428,34088
2004-12-14,6406,6590,8694,1626,4177,3110,3410,34013
2004-12-13,6373,6580,8693,1623,4160,3126,3409,33964
2004-12-10,6368,6570,8699,1621,4138,3169,3433,33998
2004-12-09,6354,6579,8701,1641,4127,3124,3409,33935
2004-12-07,6349,6578,8708,1638,4101,3120,3400,33894
2004-12-06,6401,6568,8680,1636,4091,3117,3401,33894
2004-12-03,6443,6574,8675,1635,4121,3115,3393,33956
2004-12-02,6428,6585,8675,1631,4103,3067,3412,33901
2004-12-01,6464,6604,8679,1626,4092,3092,3417,33974
2004-11-30,6375,6582,8690,1627,4174,3183,3407,34038
2004-11-29,6443,6610,8687,1602,4191,3015,3384,33932
2004-11-26,6525,6581,8687,1594,4177,2962,3374,33900
2004-11-25,6519,6550,8687,1589,4161,2927,3377,33810
2004-11-24,6329,6540,8686,1586,4140,2908,3384,33573
2004-11-23,6354,6530,8688,1580,4120,2891,3383,33546
2004-11-22,6292,6517,8689,1574,4102,2858,3386,33418
2004-11-19,6323,6515,8689,1565,4087,2831,3367,33377
2004-11-18,6291,6498,8691,1564,4068,2808,3368,33288
2004-11-17,6270,6481,8693,1561,4047,2784,3372,33208
2004-11-16,6326,6426,8695,1558,4030,2779,3384,33198
2004-11-15,6357,6435,8695,1553,4013,2741,3417,33211
2004-11-12,6192,6429,8702,1550,3995,2760,3414,33042
2004-11-11,6101,6408,8703,1547,3973,2786,3394,32912
2004-11-10,6082,6407,8696,1543,3960,2842,3376,32906
2004-11-09,6146,6393,8689,1541,3950,2950,3392,33061
2004-11-08,6148,6389,8694,1539,3933,2909,3385,32997
2004-11-05,6182,6379,8698,1536,3910,2920,3373,32998
2004-11-04,6098,6368,8697,1535,3899,2963,3376,32936
2004-11-03,6120,6344,8695,1531,3885,2953,3365,32893
2004-11-02,6176,6331,8697,1528,3878,2924,3354,32888
2004-11-01,6268,6348,8702,1530,3879,2913,3357,32997
2004-10-29,6103,6367,8713,1519,3971,3048,3361,33082
2004-10-28,6269,6336,8707,1509,3839,2917,3299,32876
2004-10-27,6346,6330,8713,1508,3832,2866,3290,32885
2004-10-26,6428,6301,8711,1506,3828,2858,3309,32941
2004-10-25,6332,6280,8715,1499,3810,2800,3329,32765
2004-10-22,6224,6276,8719,1496,3793,2773,3331,32612
2004-10-21,6214,6267,8720,1492,3778,2731,3318,32520
2004-10-20,6307,6248,8719,1489,3763,2748,3305,32579
2004-10-19,6336,6239,8720,1485,3758,2726,3306,32570
2004-10-18,6367,6244,8717,1482,3746,2699,3304,32559
2004-10-15,6313,6261,8719,1483,3723,2797,3280,32576
2004-10-14,6190,6215,8713,1480,3711,2771,3298,32378
2004-10-13,6190,6191,8739,1487,3694,2807,3287,32395
2004-10-12,6116,6211,8764,1473,3688,2896,3278,32426
2004-10-08,6028,6208,8768,1470,3676,2934,3266,32350
2004-10-07,5985,6170,8767,1468,3667,2951,3262,32270
2004-10-06,6002,6141,8772,1464,3654,2986,3286,32305
2004-10-05,6073,6129,8780,1467,3641,2965,3287,32342
2004-10-04,5917,6129,8780,1465,3690,2985,3329,32295
2004-10-01,6061,6062,8783,1465,3684,2966,3278,32299
2004-09-30,6020,6046,8793,1455,3671,3014,3259,32258
2004-09-29,6099,5960,8804,1469,3538,2907,3233,32010
2004-09-28,6186,5926,8784,1465,3528,2879,3218,31986
2004-09-27,6221,5906,8783,1461,3511,2790,3205,31877
2004-09-24,6216,5895,8791,1459,3491,2739,3204,31795
2004-09-23,6212,5783,8791,1454,3483,2722,3205,31650
2004-09-22,6183,5738,8792,1452,3475,2680,3205,31525
2004-09-21,6187,5721,8794,1448,3463,2670,3214,31497
2004-09-20,6215,5735,8795,1445,3451,2651,3213,31505
2004-09-17,6182,5736,8797,1441,3435,2634,3220,31445
2004-09-16,6174,5739,8796,1441,3421,2631,3218,31420
2004-09-15,6152,5730,8796,1437,3411,2604,3203,31333
2004-09-14,6033,5714,8800,1435,3398,2608,3226,31214
2004-09-13,5968,5712,8801,1436,3395,2630,3252,31194
2004-09-10,6015,5751,8806,1432,3383,2653,3209,31249
2004-09-09,5997,5620,8809,1429,3383,2666,3225,31129
2004-09-08,5990,5604,8811,1427,3371,2811,3225,31239
2004-09-07,6060,5617,8811,1423,3357,2846,3210,31324
2004-09-06,6066,5612,8813,1421,3359,2847,3204,31322
2004-09-03,6033,5624,8810,1420,3345,2849,3212,31293
2004-09-02,6006,5599,8807,1419,3364,2846,3200,31241
2004-09-01,6109,5610,8811,1419,3361,2879,3204,31393
2004-08-31,5950,5597,8816,1411,3342,2991,3194,31301
2004-08-30,6151,5553,8819,1414,3232,2856,3108,31133
2004-08-27,6227,5533,8820,1411,3222,2807,3107,31127
2004-08-26,6242,5509,8821,1407,3210,2778,3112,31079
2004-08-25,6313,5496,8818,1395,3197,2738,3110,31067
2004-08-24,6161,5482,8818,1392,3190,2714,3128,30885
2004-08-23,6199,5470,8822,1386,3181,2690,3130,30878
2004-08-20,6122,5491,8827,1383,3168,2663,3126,30780
2004-08-19,6166,5466,8824,1381,3158,2641,3129,30765
2004-08-18,6039,5467,8824,1379,3148,2651,3119,30627
2004-08-17,6052,5489,8827,1378,3140,2650,3113,30649
2004-08-13,5888,5461,8830,1374,3126,2665,3110,30454
2004-08-12,5834,5438,8822,1369,3125,2681,3106,30375
2004-08-11,5802,5433,8826,1368,3111,2729,3104,30373
2004-08-10,5829,5480,8835,1365,3104,2833,3115,30561
2004-08-09,5769,5478,8838,1363,3162,2854,3107,30571
2004-08-06,5775,5485,8847,1365,3148,2851,3061,30532
2004-08-05,5807,5478,8849,1363,3142,2864,3072,30575
2004-08-04,5803,5467,8853,1362,3130,2884,3077,30576
2004-08-03,5821,5456,8855,1356,3127,2860,3087,30562
2004-08-02,5794,5471,8860,1356,3122,2884,3062,30549
2004-07-30,5818,5470,8858,1354,3056,2937,3059,30552
2004-07-29,5814,5471,8881,1353,3058,2840,2977,30394
2004-07-28,5805,5447,8886,1352,3052,2793,2991,30326
2004-07-27,5852,5389,8841,1322,3047,2755,2955,30161
2004-07-26,5761,5390,8838,1321,3034,2733,2926,30003
2004-07-23,5735,5384,8842,1320,3025,2683,2927,29916
2004-07-22,5726,5369,8833,1318,3014,2679,2932,29871
2004-07-21,5801,5347,8839,1318,3006,2604,2929,29844
2004-07-20,5878,5398,8843,1317,3002,2592,2937,29967
2004-07-19,5924,5472,8843,1317,2995,2586,2841,29978
2004-07-16,5991,5473,8843,1315,2981,2595,2818,30016
2004-07-15,5938,5455,8831,1313,2974,2610,2772,29893
2004-07-14,5870,5427,8838,1314,2962,2750,2777,29938
2004-07-13,5865,5395,8839,1310,2957,2809,2774,29949
2004-07-12,5824,5467,8844,1305,2962,2853,2769,30024
2004-07-08,5773,5456,8841,1307,2972,2857,2791,29997
2004-07-07,5846,5440,8840,1304,2968,2883,2803,30084
2004-07-06,6044,5460,8838,1301,2951,2958,2799,30351
2004-07-05,6284,5435,8843,1299,2945,2966,2909,30681
2004-07-02,6134,5413,8851,1299,2943,2918,2854,30412
2004-07-01,6256,5396,8852,1296,2942,2904,2809,30455
2004-06-30,5935,5444,8848,1297,2931,2950,2850,30255
2004-06-29,5921,5494,8821,1291,2944,2862,2791,30124
2004-06-28,5975,5465,8816,1295,2937,2807,2793,30088
2004-06-25,5922,5426,8818,1292,2922,2757,2798,29935
2004-06-24,5836,5395,8819,1291,2905,2721,2811,29778
2004-06-23,5888,5378,8823,1287,2905,2711,2819,29811
2004-06-22,5824,5377,8826,1287,2895,2671,2800,29680
2004-06-18,5835,5375,8835,1285,2881,2658,2799,29668
2004-06-17,5760,5343,8837,1283,2871,2607,2805,29506
2004-06-16,5533,5366,8841,1281,2865,2595,2826,29307
2004-06-15,5449,5351,8843,1278,2858,2582,2800,29161
2004-06-14,5412,5355,8849,1293,2849,2595,2755,29108
2004-06-11,5377,5356,8907,1290,2846,2620,2761,29157
2004-06-10,5330,5344,8920,1303,2841,2592,2719,29049
2004-06-09,5388,5327,8925,1301,2837,2669,2709,29156
2004-06-08,5426,5317,8947,1299,2836,2751,2678,29254
2004-06-07,5448,5324,8904,1298,2832,2725,2694,29225
2004-06-04,5419,5314,8911,1301,2822,2739,2682,29188
2004-06-03,5382,5295,8914,1298,2860,2758,2670,29177
2004-06-02,5381,5294,8915,1296,2853,2721,2673,29133
2004-06-01,5360,5183,8879,1286,2830,2689,2664,28891
2004-05-31,5276,5204,8879,1284,2826,2839,2710,29018
2004-05-28,5415,5112,8885,1286,2823,2685,2637,28843
2004-05-27,5340,5076,8886,1280,2811,2645,2646,28684
2004-05-26,5347,5041,8886,1278,2806,2584,2644,28586
2004-05-24,5322,5101,8888,1278,2798,2542,2657,28586
2004-05-21,5302,5089,8891,1273,2788,2464,2657,28464
2004-05-20,5383,5067,8896,1271,2813,2438,2654,28522
2004-05-19,5424,5056,8899,1268,2802,2417,2621,28487
2004-05-18,5425,5070,8904,1266,2792,2420,2613,28490
2004-05-17,5475,5073,8905,1262,2785,2459,2621,28580
2004-05-14,5431,5068,8897,1261,2773,2359,2578,28367
2004-05-13,5432,5048,8897,1258,2761,2379,2597,28372
2004-05-12,5279,5035,8901,1257,2768,2424,2596,28260
2004-05-11,5236,5035,8905,1255,2762,2515,2590,28298
2004-05-10,5147,5044,8916,1257,2761,2515,2592,28232
2004-05-07,5059,5044,8921,1255,2755,2558,2597,28189
2004-05-06,5142,5057,8928,1253,2748,2561,2600,28289
2004-05-05,5061,5031,8932,1251,2743,2569,2608,28195
2004-05-04,5107,5035,8926,1263,2744,2528,2597,28200
2004-05-03,5118,5045,8929,1260,2744,2516,2595,28207
2004-04-30,4968,5018,8931,1250,2734,2624,2636,28161
2004-04-29,5108,5032,8940,1259,2760,2445,2534,28078
2004-04-28,5180,5007,8945,1258,2754,2391,2535,28070
2004-04-27,5112,4994,8940,1256,2746,2348,2527,27923
2004-04-26,5142,4986,8944,1255,2735,2299,2537,27898
2004-04-23,5216,4978,8948,1252,2727,2280,2485,27886
2004-04-22,5115,4960,8953,1250,2717,2285,2486,27766
2004-04-21,5129,4940,8955,1250,2707,2268,2494,27743
2004-04-20,5127,4925,8967,1249,2698,2271,2470,27707
2004-04-19,5143,4925,8965,1252,2692,2287,2476,27740
2004-04-16,5110,4946,8972,1252,2677,2381,2485,27823
2004-04-15,5055,4920,8982,1251,2674,2402,2433,27717
2004-04-14,4934,4929,8986,1252,2672,2417,2437,27627
2004-04-13,4900,4928,8989,1249,2667,2464,2433,27630
2004-04-12,4981,4930,8996,1248,2666,2462,2433,27716
2004-04-07,4900,4918,9005,1249,2655,2483,2421,27631
2004-04-06,4889,4945,9009,1249,2665,2479,2409,27645
2004-04-02,4909,4918,9016,1248,2666,2496,2422,27675
2004-04-01,4997,4882,9016,1251,2662,2511,2424,27743
2004-03-31,4998,4881,9015,1242,2637,2579,2522,27874
2004-03-30,4995,4879,9000,1241,2649,2430,2372,27566
2004-03-29,4956,4854,9009,1242,2645,2368,2374,27448
2004-03-26,4877,4856,9017,1240,2641,2326,2382,27339
2004-03-25,4872,4758,9024,1235,2618,2287,2541,27335
2004-03-24,4830,4748,9023,1235,2616,2272,2533,27257
2004-03-23,4848,4742,9027,1233,2605,2255,2534,27244
2004-03-22,4763,4738,9029,1233,2599,2222,2537,27121
2004-03-19,4742,4744,9033,1233,2587,2211,2532,27082
2004-03-18,4679,4739,9038,1232,2579,2189,2542,26998
2004-03-17,4673,4735,9039,1231,2570,2174,2546,26968
2004-03-16,4728,4729,9039,1230,2565,2163,2540,26994
2004-03-15,4712,4739,9043,1230,2556,2183,2518,26981
2004-03-12,4661,4746,9047,1230,2549,2205,2517,26955
2004-03-11,4627,4730,9049,1229,2557,2202,2500,26894
2004-03-10,4569,4728,9054,1228,2555,2287,2501,26922
2004-03-09,4560,4730,9062,1228,2557,2336,2520,26993
2004-03-08,4530,4736,9064,1229,2550,2357,2518,26984
2004-03-05,4548,4738,9074,1231,2540,2350,2494,26975
2004-03-04,4522,4721,9077,1235,2539,2339,2494,26927
2004-03-03,4516,4713,9080,1233,2534,2342,2497,26915
2004-03-02,4534,4734,9086,1233,2535,2318,2478,26918
2004-03-01,4513,4737,9092,1236,2537,2322,2485,26922
2004-02-27,4385,4729,9087,1224,2513,2407,2548,26893
2004-02-26,4462,4728,9093,1238,2529,2280,2478,26808
2004-02-25,4470,4725,9092,1240,2525,2243,2472,26767
2004-02-24,4409,4710,9093,1239,2517,2210,2495,26673
2004-02-23,4385,4710,9100,1242,2511,2182,2563,26693
2004-02-20,4366,4701,9110,1243,2506,2168,2559,26653
2004-02-19,4377,4707,9112,1238,2541,2176,2558,26709
2004-02-18,4335,4706,9115,1242,2535,2174,2571,26678
2004-02-17,4272,4709,9120,1241,2526,2163,2550,26581
2004-02-16,4320,4641,9124,1240,2521,2165,2545,26556
2004-02-13,4228,4653,9127,1241,2516,2176,2523,26464
2004-02-12,4123,4671,9133,1240,2505,2197,2517,26386
2004-02-11,4041,4660,9138,1238,2503,2235,2516,26331
2004-02-10,4064,4661,9148,1238,2500,2304,2513,26428
2004-02-09,4083,4682,9156,1240,2503,2305,2512,26481
2004-02-06,4050,4687,9159,1240,2496,2313,2524,26469
2004-02-05,4082,4677,9163,1239,2527,2310,2500,26498
2004-02-04,4122,4680,9170,1240,2529,2378,2501,26620
2004-02-03,4093,4669,9174,1241,2525,2323,2502,26527
2004-02-02,4121,4675,9176,1241,2515,2322,2507,26557
2004-01-30,4021,4679,9185,1240,2512,2446,2561,26644
2004-01-29,4083,4755,9190,1243,2585,2314,2502,26672
2004-01-28,4089,4685,9196,1242,2582,2264,2487,26545
2004-01-27,4132,4767,9203,1241,2573,2237,2486,26639
2004-01-26,4066,4781,9204,1242,2568,2218,2493,26572
2004-01-23,4013,4816,9210,1242,2562,2167,2487,26497
2004-01-22,3993,4821,9209,1242,2554,2166,2478,26463
2004-01-21,4011,4804,9216,1242,2548,2154,2494,26469
2004-01-20,4078,4801,9218,1244,2540,2101,2496,26478
2004-01-19,4088,4812,9219,1245,2537,2073,2500,26474
2004-01-16,4023,4813,9229,1247,2530,2083,2494,26419
2004-01-15,4079,4818,9236,1247,2527,2084,2497,26488
2004-01-14,3991,4819,9241,1248,2522,2163,2499,26483
2004-01-13,4034,4830,9246,1237,2510,2215,2484,26556
2004-01-12,4036,4828,9251,1255,2508,2260,2450,26588
2004-01-09,4071,4820,9243,1257,2515,2300,2450,26656
2004-01-08,4155,4814,9241,1257,2502,2318,2455,26742
2004-01-07,4122,4827,9231,1258,2498,2338,2464,26738
2004-01-06,4128,4831,9233,1260,2508,2356,2458,26774
2004-01-05,4169,4827,9241,1261,2502,2354,2491,26845
2004-01-02,4113,4861,9247,1262,2498,2324,2506,26811
2003-12-31,4068,4849,9193,1258,2487,2440,2559,26854
2003-12-30,4393,4860,9266,1256,2369,2386,2503,27033
2003-12-29,4457,4833,9273,1258,2374,2334,2531,27060
2003-12-26,4506,4847,9286,1258,2357,2259,2546,27059
2003-12-24,4585,4844,9289,1264,2355,2252,2534,27123
2003-12-23,4644,4771,9293,1266,2358,2221,2514,27067
2003-12-22,4507,4751,9298,1266,2352,2192,2527,26893
2003-12-19,4456,4743,9302,1265,2344,2157,2539,26806
2003-12-18,4456,4727,9303,1278,2338,2134,2533,26769
2003-12-17,4429,4700,9308,1268,2336,2127,2543,26711
2003-12-16,4475,4678,9312,1268,2326,2129,2538,26726
2003-12-15,4441,4675,9322,1269,2321,2100,2533,26661
2003-12-12,4374,4674,9335,1269,2316,2124,2597,26689
2003-12-11,4364,4639,9332,1268,2313,2161,2583,26660
2003-12-10,4354,4625,9338,1269,2315,2216,2594,26711
2003-12-09,4254,4633,9343,1270,2313,2249,2608,26670
2003-12-05,4226,4663,9355,1271,2302,2259,2609,26685
2003-12-04,4225,4668,9360,1291,2302,2262,2605,26713
2003-12-03,4233,4686,9360,1292,2327,2271,2598,26767
2003-12-02,4247,4665,9375,1297,2332,2261,2574,26751
2003-12-01,4344,4658,9375,1297,2301,2268,2627,26870
2003-11-28,4224,4658,9353,1282,2291,2317,2651,26776
2003-11-27,4301,4743,9313,1297,2319,2218,2602,26793
2003-11-26,4317,4737,9328,1297,2317,2183,2598,26777
2003-11-25,4259,4729,9322,1294,2316,2171,2605,26696
2003-11-24,4132,4720,9333,1295,2310,2147,2623,26560
2003-11-21,4143,4726,9343,1297,2297,2075,2624,26505
2003-11-20,4171,4717,9351,1299,2292,1994,2609,26433
2003-11-19,4173,4706,9354,1302,2290,1964,2613,26402
2003-11-18,4175,4698,9362,1303,2291,1953,2640,26422
2003-11-17,4165,4692,9370,1304,2281,1956,2649,26417
2003-11-14,4094,4693,9378,1306,2271,1959,2639,26340
2003-11-13,4211,4691,9384,1309,2253,1951,2658,26457
2003-11-12,4172,4694,9389,1308,2253,2019,2675,26510
2003-11-11,4165,4689,9394,1309,2247,2073,2673,26550
2003-11-10,4114,4680,9395,1291,2245,2142,2679,26546
2003-11-07,4241,4673,9397,1293,2242,2134,2687,26667
2003-11-05,4146,4671,9406,1296,2228,2165,2687,26599
2003-11-04,4184,4673,9385,1296,2228,2209,2682,26657
2003-11-03,4244,4685,9389,1291,2223,2209,2688,26729
2003-10-31,4118,4604,9458,1307,2229,2240,2674,26630
2003-10-30,4198,4704,9416,1297,2223,2153,2644,26635
2003-10-29,4210,4695,9419,1297,2207,2112,2648,26588
2003-10-28,4188,4692,9418,1300,2209,2074,2672,26553
2003-10-27,4143,4690,9416,1300,2191,2047,2682,26469
2003-10-24,4169,4699,9493,1299,2188,2008,2659,26515
2003-10-23,4174,4694,9498,1302,2184,1981,2643,26476
2003-10-22,4118,4685,9501,1302,2184,1969,2648,26407
2003-10-21,4144,4679,9507,1305,2176,1962,2661,26434
2003-10-20,4162,4676,9509,1308,2165,1970,2632,26422
2003-10-17,4050,4673,9522,1312,2158,1975,2631,26321
2003-10-16,4079,4674,9532,1314,2147,2023,2633,26402
2003-10-15,4103,4673,9538,1315,2143,2079,2631,26482
2003-10-14,4075,4676,9544,1318,2145,2165,2637,26560
2003-10-10,4054,4664,9552,1319,2137,2196,2639,26561
2003-10-09,4079,4659,9560,1322,2135,2227,2640,26622
2003-10-08,4137,4657,9566,1335,2131,2208,2642,26676
2003-10-07,4168,4648,9579,1351,2127,2208,2642,26723
2003-10-06,4237,4633,9595,1340,2123,2215,2673,26816
2003-10-03,4174,4643,9605,1343,2111,2212,2686,26774
2003-10-02,4185,4639,9611,1343,2110,2203,2687,26778
2003-10-01,4194,4630,9605,1344,2107,2166,2688,26734
2003-09-30,3987,4557,9670,1349,2081,2209,2657,26510
2003-09-29,4182,4654,9635,1330,2104,2087,2622,26614
2003-09-26,4219,4669,9636,1332,2105,2056,2616,26633
2003-09-25,4224,4651,9648,1334,2110,2023,2618,26608
2003-09-24,4117,4646,9648,1335,2105,1995,2620,26466
2003-09-23,4183,4639,9653,1336,2126,1990,2618,26545
2003-09-22,4133,4652,9651,1339,2114,1988,2627,26504
2003-09-19,4179,4722,9663,1343,2116,1973,2635,26631
2003-09-18,4136,4706,9668,1349,2111,1960,2638,26568
2003-09-17,4133,4709,9674,1350,2106,1966,2647,26585
2003-09-16,4165,4709,9681,1352,2100,1973,2655,26635
2003-09-15,4126,4710,9687,1353,2096,1960,2669,26601
2003-09-12,4076,4698,9695,1356,2090,1984,2656,26555
2003-09-11,4095,4693,9706,1357,2080,2000,2653,26584
2003-09-10,4083,4688,9719,1359,2084,2043,2643,26619
2003-09-09,4137,4745,9725,1362,2082,2108,2628,26787
2003-09-08,4090,4753,9726,1367,2079,2114,2650,26779
2003-09-05,4044,4762,9734,1369,2077,2105,2658,26749
2003-09-04,4085,4752,9740,1372,2073,2090,2637,26749
2003-09-03,4124,4738,9745,1370,2074,2112,2642,26805
2003-09-02,4136,4727,9756,1376,2076,2102,2638,26811
2003-09-01,4120,4724,9757,1377,2076,2085,2637,26776
2003-08-29,4009,4726,9765,1379,2049,2159,2610,26697
2003-08-28,4042,4743,9784,1382,2073,1938,2605,26567
2003-08-27,4052,4727,9787,1386,2071,1878,2589,26490
2003-08-26,4084,4728,9795,1388,2066,1849,2594,26504
2003-08-25,3941,4707,9794,1390,2066,1804,2599,26301
2003-08-22,3941,4692,9800,1393,2063,1785,2606,26280
2003-08-21,3999,4670,9800,1393,2057,1759,2610,26288
2003-08-20,3997,4665,9800,1396,2057,1766,2616,26297
2003-08-19,3960,4672,9813,1397,2051,1762,2618,26273
2003-08-15,3920,4664,9822,1399,2045,1769,2621,26240
2003-08-14,3975,4661,9831,1401,2042,1790,2618,26318
2003-08-13,3937,4668,9839,1413,2038,1855,2620,26370
2003-08-12,3939,4664,9848,1415,2037,1926,2619,26448
2003-08-11,3891,4661,9856,1417,2035,1951,2617,26428
2003-08-08,3931,4672,9873,1420,2040,1963,2633,26532
2003-08-07,3851,4664,9880,1423,2042,1963,2627,26450
2003-08-06,3836,4663,9889,1425,2041,1948,2629,26431
2003-08-05,3838,4666,9860,1423,2029,1956,2634,26406
2003-08-04,3875,4701,9863,1425,2028,1973,2627,26492
2003-08-01,3784,4704,9869,1427,2018,1964,2625,26391
2003-07-31,3703,4638,9954,1423,2011,2000,2699,26428
2003-07-30,3714,4689,9915,1436,2030,2023,2643,26450
2003-07-29,3700,4689,9922,1439,2029,2001,2649,26429
2003-07-28,3756,4693,9929,1442,2028,1956,2643,26447
2003-07-25,3738,4694,9935,1445,2032,1923,2634,26401
2003-07-24,3792,4695,9942,1447,2031,1887,2635,26429
2003-07-23,3800,4706,9949,1449,2031,1898,2628,26461
2003-07-22,3882,4701,9960,1452,2030,1875,2638,26538
2003-07-21,3778,4709,9963,1453,2033,1858,2639,26433
2003-07-18,3729,4712,9972,1457,2022,1865,2631,26388
2003-07-17,3721,4701,9978,1458,2020,1855,2612,26345
2003-07-16,3767,4706,9994,1461,2027,1854,2623,26432
2003-07-15,3723,4706,10001,1464,2020,1867,2624,26405
2003-07-14,3790,4706,10009,1467,2018,1864,2626,26480
2003-07-11,3740,4713,10017,1471,2031,1841,2632,26445
2003-07-10,3745,4711,10023,1473,2030,1906,2634,26522
2003-07-08,3733,4715,10043,1475,2035,1981,2648,26630
2003-07-07,3752,4720,10050,1482,2035,2026,2642,26707
2003-07-04,3737,4714,10061,1488,2036,2030,2641,26707
2003-07-03,3740,4712,10067,1488,2056,2039,2638,26740
2003-07-02,3808,4713,10074,1492,2063,2072,2634,26856
2003-07-01,3830,4715,10080,1495,2066,2066,2630,26882
2003-06-30,3753,4682,10075,1488,2036,2093,2629,26756
2003-06-27,3829,4698,10040,1478,2063,1985,2631,26724
2003-06-26,3826,4671,10047,1486,2056,1955,2705,26746
2003-06-25,3839,4667,10054,1486,2064,1930,2708,26748
2003-06-24,3864,4671,10062,1489,2066,1908,2707,26767
2003-06-23,3935,4676,10067,1492,2073,1889,2699,26831
2003-06-20,3940,4686,10074,1494,2079,1868,2691,26832
2003-06-19,3915,4701,10080,1499,2086,1841,2690,26812
2003-06-18,3821,4688,10088,1501,2084,1846,2702,26730
2003-06-17,3855,4738,10104,1504,2085,1839,2709,26834
2003-06-13,3779,4740,10125,1500,2083,1854,2715,26796
2003-06-12,3804,4737,10135,1503,2093,1871,2706,26849
2003-06-11,3799,4738,10126,1505,2091,1902,2713,26874
2003-06-10,3736,4744,10139,1508,2090,1973,2669,26859
2003-06-09,3723,4746,10151,1511,2089,1984,2686,26890
2003-06-06,3756,4750,10157,1513,2087,2004,2740,27007
2003-06-05,3785,4766,10165,1516,2091,2003,2714,27040
2003-06-04,3762,4767,10173,1531,2091,2027,2725,27076
2003-06-03,3729,4745,10102,1507,2091,2029,2724,26927
2003-06-02,3732,4756,10107,1510,2092,2026,2743,26966
2003-05-30,3661,4737,10110,1497,2107,2048,2733,26893
2003-05-29,3686,4765,10133,1526,2110,2014,2759,26993
2003-05-28,3709,4773,10143,1529,2114,1966,2764,26998
2003-05-27,3728,4772,10142,1532,2115,1927,2776,26992
2003-05-26,3715,4776,10150,1535,2135,1896,2756,26963
2003-05-23,3647,4791,10157,1536,2138,1873,2762,26904
2003-05-22,3636,4778,10165,1537,2138,1860,2774,26888
2003-05-21,3633,4777,10173,1542,2126,1842,2791,26884
2003-05-20,3700,4792,10177,1544,2141,1854,2755,26963
2003-05-19,3714,4792,10184,1548,2135,1852,2762,26987
2003-05-16,3705,4790,10192,1545,2135,1843,2782,26992
2003-05-15,3807,4699,10205,1547,2122,1834,2779,26993
2003-05-14,3763,4696,10218,1552,2127,1898,2770,27024
2003-05-13,3721,4700,10215,1555,2128,1933,2786,27038
2003-05-12,3749,4698,10228,1557,2130,1989,2795,27146
2003-05-09,3750,4703,10243,1564,2142,2002,2800,27204
2003-05-08,3803,4696,10251,1566,2147,2022,2796,27281
2003-05-07,3744,4691,10258,1569,2148,2038,2799,27247
2003-05-06,3829,4694,10265,1562,2151,2039,2800,27340
2003-05-05,3863,4696,10273,1565,2157,2021,2788,27363
2003-05-02,3843,4695,10288,1570,2171,2020,2782,27369
2003-04-30,3663,4865,10382,1553,2154,2079,2690,27386
2003-04-29,3817,4713,10336,1578,2191,1931,2769,27335
2003-04-28,3827,4716,10359,1582,2182,1898,2774,27338
2003-04-25,3786,4720,10380,1584,2189,1856,2774,27289
2003-04-24,3816,4747,10389,1588,2195,1851,2736,27322
2003-04-23,3853,4753,10420,1595,2227,1862,2727,27437
2003-04-22,3835,4756,10432,1599,2223,1854,2734,27433
2003-04-21,3791,4771,10440,1601,2225,1838,2724,27390
2003-04-16,3840,4769,10455,1611,2231,1780,2713,27399
2003-04-15,3792,4741,10458,1607,2233,1806,2688,27325
2003-04-14,3830,4745,10465,1609,2234,1826,2694,27403
2003-04-11,3725,4760,10468,1614,2234,1837,2697,27335
2003-04-10,3732,4736,10479,1617,2233,1815,2690,27302
2003-04-09,3765,4759,10490,1621,2252,1866,2685,27438
2003-04-08,3747,4782,10497,1622,2253,1934,2699,27534
2003-04-07,3699,4786,10503,1625,2253,1943,2674,27483
2003-04-04,3707,4782,10509,1628,2255,1943,2678,27502
2003-04-03,3763,4785,10520,1620,2281,1944,2667,27580
2003-04-02,3816,4787,10535,1627,2288,1959,2649,27661
2003-04-01,3786,4780,10553,1634,2287,1946,2663,27649
2003-03-28,3492,4968,10590,1637,2207,2014,2773,27681
2003-03-27,3665,4782,10592,1638,2247,1943,2800,27667
2003-03-26,3683,4809,10613,1645,2292,1911,2741,27694
2003-03-25,3803,4807,10622,1643,2295,1894,2748,27812
2003-03-24,3742,4833,10632,1647,2296,1863,2753,27766
2003-03-21,3724,4837,10652,1651,2297,1839,2746,27746
2003-03-20,3740,4831,10660,1655,2297,1839,2746,27768
2003-03-19,3727,4833,10670,1647,2294,1853,2802,27826
2003-03-18,3750,4844,10685,1680,2297,1835,2840,27931
2003-03-17,3735,4858,10698,1683,2297,1860,2833,27964
2003-03-14,3731,4857,10707,1687,2301,1876,2841,28000
2003-03-13,3750,4868,10725,1702,2310,1891,2847,28093
2003-03-12,3779,4870,10733,1705,2310,1950,2842,28189
2003-03-11,3803,4851,10741,1710,2311,1988,2791,28195
2003-03-10,3795,4892,10755,1714,2314,2002,2835,28307
2003-03-07,3753,4902,10768,1720,2370,2020,2832,28365
2003-03-06,3773,4909,10773,1724,2375,2017,2844,28415
2003-03-05,3776,4912,10785,1728,2380,2016,2841,28438
2003-03-04,3811,4914,10807,1732,2384,2012,2831,28491
2003-03-03,3813,4921,10828,1739,2388,2025,2795,28509
2003-02-28,3564,5100,10856,1722,2378,2121,2800,28541
2003-02-27,3802,4979,10865,1754,2491,1964,2735,28590
2003-02-26,3803,4972,10872,1758,2494,1915,2743,28557
2003-02-25,3843,4980,10882,1761,2499,1905,2750,28620
2003-02-24,3903,4982,10893,1766,2502,1894,2774,28714
2003-02-21,3945,4987,10900,1768,2488,1885,2769,28742
2003-02-20,3890,4996,10906,1771,2489,1869,2790,28711
2003-02-19,3997,5000,10924,1775,2510,1816,2821,28843
2003-02-18,3994,5007,10951,1778,2513,1820,2853,28916
2003-02-17,3945,5015,10961,1780,2521,1864,2845,28931
2003-02-14,3848,5001,10970,1784,2523,1864,2848,28838
2003-02-13,3844,5009,10979,1786,2527,1869,2850,28864
2003-02-12,3850,5006,10988,1791,2531,1937,2924,29027
2003-02-11,3916,5004,11001,1795,2534,1953,2905,29108
2003-02-10,3887,5009,11002,1798,2538,1999,2900,29133
2003-02-07,3860,4973,10952,1855,2541,2007,2913,29101
2003-02-06,3884,4972,10964,1864,2548,2038,2906,29176
2003-02-05,3902,4985,10978,1863,2551,2008,2906,29193
2003-02-04,3888,4986,10985,1866,2555,2024,2922,29226
2003-02-03,3896,4976,10986,1868,2562,2073,2926,29287
2003-01-31,3806,5088,11036,1861,2497,2204,2811,29303
2003-01-30,3999,5099,10982,1834,2575,2039,2639,29167
2003-01-29,4079,5011,10991,1839,2579,1984,2628,29111
2003-01-28,4004,5032,11000,1840,2583,1982,2624,29065
2003-01-27,4020,5047,11018,1844,2583,1976,2630,29118
2003-01-24,4016,5032,11025,1847,2584,1946,2631,29081
2003-01-23,4045,5038,11033,1852,2578,1906,2660,29112
2003-01-22,4027,5030,11022,1860,2581,1889,2671,29080
2003-01-21,4100,5037,11033,1862,2590,1857,2670,29149
2003-01-20,4145,5047,11042,1868,2586,1842,2675,29205
2003-01-17,4122,5064,11052,1869,2591,1838,2671,29207
2003-01-16,4161,5072,11059,1874,2600,1818,2698,29282
2003-01-15,4310,5077,11075,1876,2604,1805,2714,29461
2003-01-14,4320,5082,11085,1883,2601,1794,2742,29507
2003-01-13,4307,5089,11093,1885,2620,1801,2735,29530
2003-01-10,4216,5094,11105,1891,2631,1860,2734,29531
2003-01-09,4166,5102,11117,1893,2637,1875,2713,29503
2003-01-08,4181,5101,11122,1896,2641,1914,2711,29566
2003-01-07,4121,5113,11132,1897,2648,1984,2700,29595
2003-01-06,4207,5126,11144,1905,2647,1990,2695,29714
2003-01-03,4255,5135,11159,1910,2670,2017,2715,29861
2003-01-02,4199,5163,11170,1908,2692,2042,2705,29879
2002-12-31,3948,5447,11367,2000,2572,2202,2844,30380
