fecha,Adelantos,Documentos,Hipotecarios,Prendarios,Personales,Tarjetas,Otros,TOTAL
2025-10-20,191,13339,515,1027,0,466,2564,18102
2025-10-17,195,13394,512,1026,0,454,2572,18153
2025-10-16,196,13430,511,1026,0,444,2581,18188
2025-10-15,197,13443,510,1025,0,438,2601,18214
2025-10-14,196,13476,509,1025,0,443,2612,18261
2025-10-13,197,13431,510,1026,0,407,2591,18162
2025-10-09,198,13465,508,1026,0,508,2571,18276
2025-10-08,197,13386,507,1023,0,534,2566,18213
2025-10-07,198,13433,505,1019,0,586,2564,18305
2025-10-06,198,13478,505,1017,0,594,2565,18357
2025-10-03,199,13590,505,1012,0,690,2575,18571
2025-10-02,211,13604,504,1011,0,710,2550,18590
2025-10-01,214,13699,504,1011,0,724,2551,18703
2025-09-30,214,13703,501,1009,0,729,2554,18710
2025-09-29,224,13795,498,1006,0,710,2554,18787
2025-09-26,228,13736,497,1006,0,714,2547,18728
2025-09-25,221,13801,497,1005,0,698,2501,18723
2025-09-24,224,13725,495,969,0,693,2494,18600
2025-09-23,234,13700,491,969,0,675,2457,18526
2025-09-22,233,13695,488,970,0,633,2459,18478
2025-09-19,230,13679,486,970,0,607,2455,18427
2025-09-18,232,13661,484,968,0,603,2447,18395
2025-09-17,232,13656,482,968,0,587,2433,18358
2025-09-16,232,13591,481,968,0,572,2411,18255
2025-09-15,232,13541,480,968,0,530,2409,18160
2025-09-12,234,13518,480,968,0,505,2399,18104
2025-09-11,233,13554,479,970,0,485,2389,18110
2025-09-10,232,13546,477,970,0,466,2375,18066
2025-09-09,231,13603,477,971,0,452,2367,18101
2025-09-08,231,13594,472,970,0,414,2363,18044
2025-09-05,231,13592,469,970,0,436,2367,18065
2025-09-04,233,13571,467,970,0,475,2365,18081
2025-09-03,232,13562,466,969,0,526,2370,18125
2025-09-02,232,13548,465,969,0,566,2334,18114
2025-09-01,232,13533,462,969,0,553,2336,18085
2025-08-29,232,13511,466,965,0,624,2481,18279
2025-08-28,231,13389,460,965,0,644,2310,17999
2025-08-27,230,13327,458,964,0,635,2234,17848
2025-08-26,230,13307,455,962,0,640,2234,17828
2025-08-25,230,13189,456,961,0,614,2232,17682
2025-08-22,229,13145,456,961,0,609,2232,17632
2025-08-21,228,13121,453,960,0,593,2227,17582
2025-08-20,228,13094,456,958,0,575,2228,17539
2025-08-19,228,13065,456,957,0,563,2211,17480
2025-08-18,227,12907,453,953,0,529,2221,17290
2025-08-14,229,12910,453,951,0,487,2212,17242
2025-08-13,228,12855,433,950,0,464,2209,17139
2025-08-12,227,12794,430,951,0,463,2203,17068
2025-08-11,227,12746,427,952,0,469,2140,16961
2025-08-08,226,12748,428,948,0,473,2136,16959
2025-08-07,214,12752,428,947,0,555,2136,17032
2025-08-06,213,12730,427,947,0,590,2131,17038
2025-08-05,212,12643,422,947,0,652,2120,16996
2025-08-04,219,12649,422,947,0,672,2120,17029
2025-08-01,221,12635,421,947,0,789,2120,17133
2025-07-31,220,12632,421,940,0,764,2246,17223
2025-07-30,219,12611,420,941,0,801,2111,17103
2025-07-29,219,12569,418,940,0,785,2144,17075
2025-07-28,219,12519,418,938,0,760,2122,16976
2025-07-25,219,12557,419,934,0,756,2099,16984
2025-07-24,209,12471,418,934,0,736,2100,16868
2025-07-23,208,12461,417,934,0,722,2100,16842
2025-07-22,207,12412,417,933,0,700,2097,16766
2025-07-21,199,12333,417,931,0,654,2093,16627
2025-07-18,199,12352,417,931,0,629,2088,16616
2025-07-17,200,12360,417,930,0,622,2036,16565
2025-07-16,195,12394,414,930,0,598,2037,16568
2025-07-15,195,12401,410,931,0,580,2032,16549
2025-07-14,199,12410,408,928,0,532,2029,16506
2025-07-11,199,12497,408,928,0,508,2018,16558
2025-07-10,209,12507,406,927,0,472,2017,16538
2025-07-08,209,12489,406,926,0,446,1987,16463
2025-07-07,207,12513,404,925,0,440,1989,16478
2025-07-04,204,12444,404,926,0,466,1981,16425
2025-07-03,188,12412,403,925,0,513,1964,16405
2025-07-02,189,12291,403,924,0,577,1859,16243
2025-07-01,189,12267,402,924,0,607,1872,16261
2025-06-30,195,12199,403,922,0,629,1868,16216
2025-06-27,195,12206,412,920,0,684,1871,16288
2025-06-26,194,12201,395,918,0,681,1872,16261
2025-06-25,227,12186,392,917,0,683,1871,16276
2025-06-24,194,12169,393,913,0,674,1713,16056
2025-06-23,195,12109,391,911,0,625,1702,15933
2025-06-19,221,12131,391,910,0,637,1689,15979
2025-06-18,219,12113,391,912,0,597,1693,15925
2025-06-17,217,12051,391,911,0,546,1674,15790
2025-06-13,217,12098,390,913,0,522,1656,15796
2025-06-12,216,12051,391,912,0,507,1641,15718
2025-06-11,227,12057,392,885,0,489,1640,15690
2025-06-10,247,11909,392,885,0,483,1636,15552
2025-06-09,248,11915,392,884,0,474,1628,15541
2025-06-06,247,11910,392,885,0,447,1639,15520
2025-06-05,246,11867,392,885,0,533,1633,15556
2025-06-04,247,11855,392,884,0,564,1610,15552
2025-06-03,247,11823,392,885,0,516,1608,15471
2025-06-02,246,11810,387,882,0,602,1603,15530
2025-05-30,246,11846,387,881,0,672,1601,15633
2025-05-29,246,11831,384,879,0,709,1630,15679
2025-05-28,245,11787,379,878,0,711,1687,15687
2025-05-27,245,11763,378,875,0,700,1682,15643
2025-05-26,246,11676,378,874,0,666,1607,15447
2025-05-23,245,11687,374,873,0,666,1605,15450
2025-05-22,245,11665,375,871,0,649,1590,15395
2025-05-21,240,11623,374,869,0,628,1528,15262
2025-05-20,235,11594,373,868,0,615,1570,15255
2025-05-19,226,11598,372,865,0,560,1571,15192
2025-05-16,227,11560,371,864,0,537,1570,15129
2025-05-15,230,11522,371,865,0,530,1570,15088
2025-05-14,230,11461,368,864,0,512,1569,15004
2025-05-13,234,11431,369,863,0,499,1567,14963
2025-05-12,243,11281,369,859,0,463,1537,14752
2025-05-09,243,11196,369,857,0,488,1521,14674
2025-05-08,241,11164,369,854,0,551,1498,14677
2025-05-07,249,11046,370,853,0,592,1495,14605
2025-05-06,249,10961,369,850,0,641,1486,14556
2025-05-05,252,10925,369,847,0,647,1483,14523
2025-04-30,250,10867,370,843,0,681,1498,14509
2025-04-29,250,10860,367,845,0,743,1494,14559
2025-04-28,250,10780,366,844,0,713,1493,14446
2025-04-25,248,10774,365,839,0,720,1469,14415
2025-04-24,247,10759,365,831,0,704,1465,14371
2025-04-23,246,10749,363,836,0,682,1471,14347
2025-04-22,245,10699,363,839,0,672,1488,14306
2025-04-21,246,10707,360,841,0,613,1490,14257
2025-04-16,247,10700,360,817,0,583,1480,14187
2025-04-15,249,10726,355,812,0,572,1477,14191
2025-04-14,249,10704,355,805,0,531,1477,14121
2025-04-11,250,10768,355,822,0,509,1489,14193
2025-04-10,252,10789,356,821,0,491,1487,14196
2025-04-09,250,10810,356,821,0,474,1486,14197
2025-04-08,245,10811,356,817,0,458,1485,14172
2025-04-07,245,10922,353,817,0,457,1449,14243
2025-04-04,244,10914,353,813,0,497,1449,14270
2025-04-03,244,10903,353,809,0,565,1449,14323
2025-04-01,243,10925,352,806,0,606,1458,14390
2025-03-31,244,10866,349,789,0,614,1476,14338
2025-03-28,243,10879,348,801,0,693,1489,14453
2025-03-27,243,10837,346,799,0,688,1481,14394
2025-03-26,243,10844,344,798,0,685,1449,14363
2025-03-25,243,10813,342,795,0,641,1456,14290
2025-03-21,243,10846,341,794,0,655,1430,14309
2025-03-20,241,10861,340,790,0,634,1428,14294
2025-03-19,239,10839,340,789,0,623,1426,14256
2025-03-18,231,10823,338,785,0,595,1424,14196
2025-03-17,230,10769,336,783,0,557,1421,14096
2025-03-14,232,10667,331,784,0,543,1417,13974
2025-03-13,234,10624,331,780,0,537,1418,13924
2025-03-12,232,10573,331,791,0,524,1408,13859
2025-03-11,231,10510,329,790,0,521,1418,13799
2025-03-10,232,10461,329,769,0,496,1413,13700
2025-03-07,232,10538,329,768,0,575,1474,13916
2025-03-06,233,10520,328,760,0,671,1490,14002
2025-03-05,232,10501,327,759,0,647,1491,13957
2025-02-28,231,10455,326,744,0,714,1445,13915
2025-02-27,230,10394,322,755,0,764,1437,13902
2025-02-26,235,10380,319,754,0,760,1433,13881
2025-02-25,217,10315,319,753,0,754,1233,13591
2025-02-24,217,10294,319,751,0,736,1431,13748
2025-02-21,203,10288,316,748,0,736,1234,13525
2025-02-20,202,10192,316,745,0,718,1237,13410
2025-02-19,201,10136,316,744,0,699,1246,13342
2025-02-18,201,10144,314,743,0,674,1232,13308
2025-02-17,200,10037,315,741,0,620,1231,13144
2025-02-14,198,9996,313,740,0,597,1230,13074
2025-02-13,192,9971,313,738,0,592,1222,13028
2025-02-12,188,9923,312,738,0,572,1222,12955
2025-02-11,175,9883,311,734,0,565,1222,12890
2025-02-10,161,9882,308,734,0,526,1219,12830
2025-02-07,162,9872,309,730,0,600,1200,12873
2025-02-06,148,9820,309,729,0,662,1198,12866
2025-02-05,147,9642,308,715,0,702,1150,12664
2025-02-04,147,9622,308,713,0,753,1154,12697
2025-02-03,147,9592,308,711,0,757,1146,12661
2025-01-31,148,9581,307,710,0,810,1135,12691
2025-01-30,148,9519,305,706,0,862,1144,12684
2025-01-29,148,9456,303,705,0,861,1144,12617
2025-01-28,146,9410,303,702,0,850,1145,12556
2025-01-27,145,9283,302,699,0,814,1148,12391
2025-01-24,145,9213,301,696,0,813,1144,12312
2025-01-23,144,9088,300,694,0,791,1152,12169
2025-01-22,145,9060,300,690,0,772,1143,12110
2025-01-21,144,9016,300,688,0,742,1146,12036
2025-01-20,144,8964,298,688,0,689,1133,11916
2025-01-17,141,8882,298,686,0,667,1131,11805
2025-01-16,137,8791,298,685,0,651,1133,11695
2025-01-15,131,8673,298,683,0,628,1092,11505
2025-01-14,130,8612,296,682,0,606,1080,11406
2025-01-13,130,8564,296,682,0,553,1079,11304
2025-01-10,130,8448,291,681,0,523,1073,11146
2025-01-09,131,8355,291,689,0,498,1081,11045
2025-01-08,130,8316,291,688,0,476,1080,10981
2025-01-07,130,8273,288,688,0,454,1080,10913
2025-01-06,131,8245,287,683,0,460,1055,10861
2025-01-03,114,8211,287,681,0,469,1075,10837
2025-01-02,112,8202,286,681,0,493,1082,10856
2024-12-30,128,8199,286,669,0,485,1061,10828
2024-12-27,121,8042,285,683,0,524,1056,10711
2024-12-26,121,7973,282,682,0,508,1073,10639
2024-12-23,120,7917,278,681,0,490,1069,10555
2024-12-20,119,7659,277,678,0,494,1042,10269
2024-12-19,121,7597,269,678,0,482,1042,10189
2024-12-18,112,7546,268,676,0,473,1061,10136
2024-12-17,111,7540,268,673,0,459,1021,10072
2024-12-16,111,7444,268,672,0,428,1025,9948
2024-12-13,111,7421,268,670,0,413,1028,9911
2024-12-12,115,7363,267,669,0,404,1022,9840
2024-12-11,114,7327,262,671,0,392,993,9759
2024-12-10,113,7223,261,673,0,387,993,9650
2024-12-09,113,7164,258,656,0,365,979,9535
2024-12-06,113,7082,257,656,0,406,969,9483
2024-12-05,112,6991,252,655,0,427,963,9400
2024-12-04,111,6953,251,655,0,433,961,9364
2024-12-03,109,6873,248,653,0,443,962,9288
2024-12-02,103,6832,248,653,0,429,956,9221
2024-11-29,97,6808,248,651,0,471,963,9238
2024-11-28,96,6744,243,652,0,504,948,9187
2024-11-27,96,6699,243,651,0,507,941,9137
2024-11-26,85,6645,240,651,0,503,940,9064
2024-11-25,85,6625,239,648,0,486,936,9019
2024-11-22,84,6596,239,648,0,488,935,8990
2024-11-21,83,6553,241,647,0,474,925,8923
2024-11-20,82,6547,232,646,0,461,918,8886
2024-11-19,82,6513,232,646,0,425,904,8802
2024-11-15,80,6515,232,645,0,407,980,8859
2024-11-14,78,6475,230,645,0,399,978,8805
2024-11-13,76,6431,230,645,0,394,975,8751
2024-11-12,77,6227,231,644,0,381,948,8508
2024-11-11,76,6159,230,655,0,373,941,8434
2024-11-08,75,6179,231,655,0,417,941,8498
2024-11-07,69,6144,230,653,0,446,937,8479
2024-11-05,68,6161,230,650,0,477,924,8510
2024-11-04,67,6128,230,648,0,477,920,8470
2024-11-01,66,6100,230,648,0,578,920,8542
2024-10-31,65,6059,231,637,0,546,847,8385
2024-10-30,64,6000,229,646,0,590,840,8369
2024-10-29,79,5951,228,644,0,588,822,8312
2024-10-28,79,5910,228,641,0,555,817,8230
2024-10-25,95,5889,228,638,0,575,836,8261
2024-10-24,95,5853,227,636,0,563,833,8207
2024-10-23,94,5817,226,632,0,555,834,8158
2024-10-22,94,5774,226,632,0,544,834,8104
2024-10-21,96,5733,226,630,0,516,833,8034
2024-10-18,95,5663,227,626,0,504,834,7949
2024-10-17,94,5618,227,624,0,494,834,7891
2024-10-16,94,5602,226,620,0,484,833,7859
2024-10-15,93,5548,226,621,0,466,832,7786
2024-10-14,93,5568,224,620,0,432,835,7772
2024-10-10,93,5566,223,620,0,413,834,7749
2024-10-09,93,5497,223,609,0,399,833,7654
2024-10-08,93,5479,222,607,0,390,839,7630
2024-10-07,92,5409,217,609,0,389,834,7550
2024-10-04,112,5405,218,609,0,394,835,7573
2024-10-03,127,5405,215,596,0,422,832,7597
2024-10-02,127,5371,214,594,0,444,832,7582
2024-10-01,127,5340,214,594,0,460,830,7565
2024-09-30,126,5303,215,594,0,453,831,7522
2024-09-27,126,5263,214,592,0,489,842,7526
2024-09-26,130,5255,214,592,0,482,839,7512
2024-09-25,115,5248,214,590,0,479,810,7456
2024-09-24,114,5217,209,589,0,476,805,7410
2024-09-23,118,5191,209,588,0,459,794,7359
2024-09-20,118,5165,210,586,0,460,786,7325
2024-09-19,103,5108,209,585,0,448,774,7227
2024-09-18,108,5106,209,581,0,440,775,7219
2024-09-17,119,5089,208,580,0,419,786,7201
2024-09-16,119,5093,207,579,0,396,788,7182
2024-09-13,118,5083,206,577,0,378,788,7150
2024-09-12,117,5082,207,577,0,368,788,7139
2024-09-11,117,5059,207,575,0,361,787,7106
2024-09-10,128,5040,206,575,0,354,786,7089
2024-09-09,121,5015,206,579,0,330,786,7037
2024-09-06,120,5022,206,578,0,362,804,7092
2024-09-05,120,5025,208,574,0,383,806,7116
2024-09-04,100,5012,208,568,0,388,804,7080
2024-09-03,101,5014,208,567,0,399,805,7094
2024-09-02,101,5004,208,565,0,392,785,7055
2024-08-30,100,5000,208,563,0,422,789,7082
2024-08-29,96,5013,207,564,0,450,796,7126
2024-08-28,96,5010,206,563,0,459,785,7119
2024-08-27,96,4790,206,561,0,454,692,6799
2024-08-26,96,4786,203,556,0,434,694,6769
2024-08-23,96,4744,203,556,0,441,690,6730
2024-08-22,105,4752,202,555,0,432,689,6735
2024-08-21,96,4744,202,553,0,425,686,6706
2024-08-20,93,4734,199,553,0,411,677,6667
2024-08-19,93,4734,201,552,0,386,675,6641
2024-08-16,93,4729,200,549,0,375,672,6618
2024-08-15,97,4714,201,547,0,370,678,6607
2024-08-14,97,4707,199,538,0,360,680,6581
2024-08-13,96,4726,197,533,0,349,679,6580
2024-08-12,96,4717,197,529,0,350,681,6570
2024-08-09,96,4732,196,527,0,377,688,6616
2024-08-08,95,4772,196,513,0,409,684,6669
2024-08-07,85,4753,196,511,0,421,686,6652
2024-08-06,85,4754,195,510,0,452,685,6681
2024-08-05,85,4753,195,508,0,443,688,6672
2024-08-02,82,4761,194,502,0,523,690,6752
2024-08-01,82,4746,194,502,0,527,687,6738
2024-07-31,82,4673,195,508,0,511,683,6652
2024-07-30,82,4661,192,499,0,538,682,6654
2024-07-29,82,4662,193,496,0,519,680,6632
2024-07-26,82,4670,193,495,0,532,664,6636
2024-07-25,82,4670,193,492,0,524,655,6616
2024-07-24,82,4706,193,486,0,517,645,6629
2024-07-23,82,4704,193,486,0,504,651,6620
2024-07-22,81,4692,193,485,0,476,651,6578
2024-07-19,83,4656,193,482,0,462,652,6528
2024-07-18,83,4661,193,481,0,454,654,6526
2024-07-17,83,4647,192,481,0,443,662,6508
2024-07-16,83,4645,192,479,0,431,666,6496
2024-07-15,93,4694,172,477,0,404,665,6505
2024-07-12,92,4701,172,476,0,389,666,6496
2024-07-11,93,4684,170,475,0,378,660,6460
2024-07-10,119,4692,170,473,0,362,660,6476
2024-07-08,132,4648,169,463,0,344,670,6426
2024-07-05,132,4649,169,461,0,363,676,6450
2024-07-04,132,4641,168,459,0,381,674,6455
2024-07-03,132,4620,169,455,0,395,674,6445
2024-07-02,132,4669,169,452,0,413,667,6502
2024-07-01,132,4618,167,451,0,401,677,6446
2024-06-28,132,4566,170,465,0,429,665,6427
2024-06-27,122,4564,166,454,0,445,667,6418
2024-06-26,123,4577,166,452,0,494,665,6477
2024-06-25,122,4616,166,451,0,443,668,6466
2024-06-24,122,4617,167,451,0,405,666,6428
2024-06-19,122,4614,167,447,0,402,677,6429
2024-06-18,122,4637,168,447,0,374,687,6435
2024-06-14,122,4658,168,445,0,357,694,6444
2024-06-13,125,4666,165,442,0,362,671,6431
2024-06-12,125,4602,165,439,0,352,688,6371
2024-06-11,111,4591,164,435,0,349,699,6349
2024-06-10,111,4574,164,432,0,327,701,6309
2024-06-07,111,4567,163,429,0,358,713,6341
2024-06-06,112,4578,163,420,0,383,714,6370
2024-06-05,112,4554,162,418,0,398,715,6359
2024-06-04,112,4534,156,416,0,415,728,6361
2024-06-03,112,4542,150,415,0,410,728,6357
2024-05-31,125,4531,161,422,0,398,743,6380
2024-05-30,125,4564,150,408,0,453,740,6440
2024-05-29,125,4548,154,406,0,454,741,6428
2024-05-28,125,4551,152,402,0,447,753,6430
2024-05-27,125,4541,154,398,0,434,728,6380
2024-05-24,125,4529,154,394,0,437,725,6364
2024-05-23,125,4535,152,390,0,426,726,6354
2024-05-22,125,4529,152,386,0,418,737,6347
2024-05-21,125,4495,152,384,0,406,760,6322
2024-05-20,125,4482,152,382,0,382,764,6287
2024-05-17,125,4455,151,380,0,364,775,6250
2024-05-16,125,4439,154,378,0,351,786,6233
2024-05-15,125,4399,154,374,0,336,787,6175
2024-05-14,135,4371,154,373,0,324,789,6146
2024-05-13,131,4340,153,371,0,299,787,6081
2024-05-10,131,4265,154,368,0,326,805,6049
2024-05-09,131,4187,154,366,0,311,806,5955
2024-05-08,131,4187,154,354,0,338,804,5968
2024-05-07,131,4149,154,351,0,361,795,5941
2024-05-06,131,4116,153,349,0,362,789,5900
2024-05-03,131,4110,153,346,0,412,791,5943
2024-05-02,130,4051,153,342,0,415,794,5885
2024-04-30,130,3997,154,352,0,398,795,5826
2024-04-29,132,3941,153,335,0,423,780,5764
2024-04-26,132,3913,152,333,0,433,782,5745
2024-04-25,132,3856,152,328,0,429,726,5623
2024-04-24,132,3898,152,324,0,427,740,5673
2024-04-23,132,3860,152,322,0,418,736,5620
2024-04-22,132,3812,153,320,0,401,734,5552
2024-04-19,127,3809,155,318,0,392,717,5518
2024-04-18,127,3779,151,313,0,385,719,5474
2024-04-17,123,3763,151,310,0,377,718,5442
2024-04-16,123,3716,151,308,0,369,686,5353
2024-04-15,123,3683,151,304,0,350,686,5297
2024-04-12,122,3635,151,301,0,332,696,5237
2024-04-11,122,3625,151,294,0,323,699,5214
2024-04-10,122,3540,151,283,0,328,697,5121
2024-04-09,121,3518,151,279,0,320,699,5088
2024-04-08,122,3477,151,273,0,317,697,5037
2024-04-05,122,3432,150,271,0,323,694,4992
2024-04-04,121,3354,149,266,0,352,689,4931
2024-04-03,121,3284,149,263,0,309,689,4815
2024-03-27,122,3360,150,272,0,306,702,4912
2024-03-26,120,3323,149,255,0,339,674,4860
2024-03-25,119,3242,149,251,0,328,673,4762
2024-03-22,119,3208,149,249,0,333,674,4732
2024-03-21,96,3162,149,248,0,335,675,4665
2024-03-20,96,3110,148,245,0,332,674,4605
2024-03-19,96,3068,149,243,0,325,662,4543
2024-03-18,96,3023,149,243,0,299,640,4450
2024-03-15,96,3006,149,243,0,304,661,4459
2024-03-14,80,2939,149,242,0,290,628,4328
2024-03-13,68,2870,149,242,0,287,614,4230
2024-03-12,68,2836,149,242,0,284,609,4188
2024-03-11,68,2774,149,242,0,269,607,4109
2024-03-08,68,2726,149,241,0,287,604,4075
2024-03-07,28,2681,137,239,0,305,603,3993
2024-03-06,28,2682,135,238,0,307,580,3970
2024-03-05,28,2554,136,239,0,317,581,3855
2024-03-04,28,2548,136,239,0,309,577,3837
2024-03-01,28,2468,136,238,0,344,549,3763
2024-02-29,28,2446,137,241,0,308,550,3710
2024-02-28,29,2844,136,238,0,341,564,4152
2024-02-27,28,2785,136,238,0,337,567,4091
2024-02-26,28,2759,136,237,0,325,570,4055
2024-02-23,25,2756,136,236,0,326,577,4056
2024-02-22,24,2674,136,237,0,318,570,3959
2024-02-21,21,2661,136,237,0,315,568,3938
2024-02-20,21,2661,136,237,0,309,574,3938
2024-02-19,21,2645,136,237,0,294,560,3893
2024-02-16,21,2636,136,238,0,286,560,3877
2024-02-15,19,2633,136,237,0,280,559,3864
2024-02-14,19,2626,139,237,0,259,563,3843
2024-02-09,20,2552,140,237,0,280,567,3796
2024-02-08,20,2555,140,237,0,303,567,3822
2024-02-07,20,2557,141,229,0,310,574,3831
2024-02-06,20,2549,141,229,0,304,578,3821
2024-02-05,20,2528,141,229,0,298,578,3794
2024-02-02,19,2529,142,229,0,333,582,3834
2024-02-01,19,2519,142,229,0,332,581,3822
2024-01-31,18,2514,143,237,0,325,588,3825
2024-01-30,18,2497,142,228,0,331,581,3797
2024-01-29,19,2476,143,226,0,320,589,3773
2024-01-26,19,2480,139,227,0,319,589,3773
2024-01-25,19,2477,139,226,0,314,566,3741
2024-01-24,19,2476,139,227,0,309,556,3726
2024-01-23,19,2454,140,227,0,300,554,3694
2024-01-22,19,2449,140,227,0,286,543,3664
2024-01-19,19,2412,140,227,0,278,546,3622
2024-01-18,19,2411,141,228,0,275,540,3614
2024-01-17,19,2340,140,228,0,266,534,3527
2024-01-16,19,2307,140,228,0,256,533,3483
2024-01-15,19,2292,140,228,0,244,544,3467
2024-01-12,19,2271,140,229,0,231,542,3432
2024-01-11,19,2255,139,229,0,222,542,3406
2024-01-10,17,2255,139,222,0,219,539,3391
2024-01-09,17,2240,139,222,0,216,540,3374
2024-01-08,17,2259,139,223,0,209,524,3371
2024-01-05,17,2240,139,223,0,229,526,3374
2024-01-04,13,2215,139,223,0,243,526,3359
2024-01-03,14,2200,139,223,0,252,524,3352
2024-01-02,14,2215,141,224,0,246,543,3383
2023-12-29,14,2212,143,235,0,263,544,3411
2023-12-28,10,2214,142,228,0,268,560,3422
2023-12-27,10,2213,142,228,0,278,562,3433
2023-12-26,10,2200,142,168,0,279,576,3375
2023-12-22,10,2197,141,168,0,282,583,3381
2023-12-21,10,2201,141,168,0,279,583,3382
2023-12-20,10,2198,141,168,0,283,580,3380
2023-12-19,10,2189,141,167,0,280,580,3367
2023-12-18,10,2207,141,168,0,270,584,3380
2023-12-15,10,2202,142,168,0,271,588,3381
2023-12-14,11,2207,143,167,0,275,593,3396
2023-12-13,11,2210,143,167,0,274,596,3401
2023-12-12,11,2237,144,226,0,278,658,3554
2023-12-11,11,2239,144,226,0,278,658,3556
2023-12-07,11,2237,144,228,0,338,658,3616
2023-12-06,11,2252,146,219,0,350,652,3630
2023-12-05,11,2257,146,220,0,357,640,3631
2023-12-04,16,2258,146,219,0,361,629,3629
2023-12-01,17,2258,146,219,0,414,628,3682
2023-11-30,11,2259,149,231,0,398,660,3708
2023-11-29,11,2281,151,221,0,421,633,3718
2023-11-28,11,2282,151,221,0,412,638,3715
2023-11-27,11,2290,151,220,0,399,635,3706
2023-11-24,11,2297,151,220,0,401,641,3721
2023-11-23,11,2309,152,221,0,393,645,3731
2023-11-22,11,2312,152,221,0,391,646,3733
2023-11-21,11,2315,153,221,0,362,647,3709
2023-11-17,11,2324,153,222,0,362,655,3727
2023-11-16,11,2324,153,222,0,357,655,3722
2023-11-15,12,2326,153,222,0,351,649,3713
2023-11-14,12,2361,153,223,0,341,684,3774
2023-11-13,11,2380,153,223,0,325,693,3785
2023-11-10,11,2393,154,216,0,314,682,3770
2023-11-09,11,2395,153,216,0,308,681,3764
2023-11-08,11,2399,153,216,0,304,691,3774
2023-11-07,12,2402,153,215,0,295,647,3724
2023-11-03,12,2407,154,216,0,343,652,3784
2023-11-02,12,2411,154,215,0,364,652,3808
2023-11-01,12,2416,154,215,0,370,654,3821
2023-10-31,12,2412,156,224,0,398,682,3884
2023-10-30,12,2420,154,215,0,388,658,3847
2023-10-27,12,2423,154,215,0,392,665,3861
2023-10-26,12,2422,154,215,0,381,655,3839
2023-10-25,12,2425,154,215,0,384,651,3841
2023-10-24,12,2428,154,214,0,374,655,3837
2023-10-23,12,2431,154,213,0,356,656,3822
2023-10-20,12,2437,156,213,0,355,664,3837
2023-10-19,13,2456,156,214,0,346,658,3843
2023-10-18,13,2460,156,214,0,344,648,3835
2023-10-17,13,2464,157,214,0,306,680,3834
2023-10-12,14,2513,157,215,0,298,689,3886
2023-10-11,14,2516,158,216,0,286,680,3870
2023-10-10,14,2528,158,206,0,274,679,3859
2023-10-09,14,2520,158,206,0,256,696,3850
2023-10-06,14,2530,158,205,0,298,642,3847
2023-10-05,14,2535,158,205,0,329,640,3881
2023-10-04,14,2542,158,204,0,326,635,3879
2023-10-03,14,2504,158,204,0,328,642,3850
2023-10-02,14,2505,160,204,0,316,643,3842
2023-09-29,14,2508,164,212,0,344,674,3916
2023-09-28,14,2516,161,203,0,349,655,3898
2023-09-27,14,2515,161,203,0,345,657,3895
2023-09-26,14,2524,161,203,0,336,671,3909
2023-09-25,15,2522,161,203,0,314,665,3880
2023-09-22,16,2524,162,203,0,313,650,3868
2023-09-21,16,2528,162,203,0,304,647,3860
2023-09-20,16,2529,162,203,0,301,643,3854
2023-09-19,16,2535,162,202,0,291,642,3848
2023-09-18,16,2534,162,204,0,270,652,3838
2023-09-15,16,2543,163,203,0,260,656,3841
2023-09-14,16,2535,167,202,0,256,646,3822
2023-09-13,16,2534,167,202,0,250,642,3811
2023-09-12,15,2535,167,202,0,244,645,3808
2023-09-11,16,2531,167,202,0,229,643,3788
2023-09-08,16,2542,167,202,0,267,647,3841
2023-09-07,16,2547,168,202,0,293,646,3872
2023-09-06,16,2553,168,201,0,295,645,3878
2023-09-05,16,2562,168,197,0,296,637,3876
2023-09-04,16,2563,166,197,0,300,582,3824
2023-09-01,16,2567,166,197,0,345,582,3873
2023-08-31,16,2574,172,201,0,333,608,3904
2023-08-30,16,2570,168,197,0,273,580,3804
2023-08-29,16,2565,170,196,0,267,585,3799
2023-08-28,16,2558,170,175,0,253,593,3765
2023-08-25,17,2563,170,175,0,254,603,3782
2023-08-24,17,2558,170,175,0,249,604,3773
2023-08-23,17,2554,170,174,0,249,606,3770
2023-08-22,17,2549,171,174,0,229,612,3752
2023-08-18,17,2549,173,174,0,222,607,3742
2023-08-17,17,2546,173,175,0,221,600,3732
2023-08-16,17,2550,173,175,0,216,597,3728
2023-08-15,17,2522,173,175,0,208,596,3691
2023-08-14,17,2522,173,175,0,194,599,3680
2023-08-11,17,2544,174,182,0,193,600,3710
2023-08-10,18,2546,173,182,0,189,582,3690
2023-08-09,17,2566,174,182,0,188,568,3695
2023-08-08,20,2570,174,183,0,186,555,3688
2023-08-07,20,2570,174,182,0,172,551,3669
2023-08-04,20,2582,174,183,0,207,555,3721
2023-08-03,21,2586,171,183,0,232,553,3746
2023-08-02,21,2587,171,183,0,225,552,3739
2023-08-01,21,2591,171,183,0,234,554,3754
2023-07-31,20,2593,175,195,0,305,559,3847
2023-07-28,21,2608,172,178,0,258,556,3793
2023-07-27,22,2614,172,177,0,250,556,3791
2023-07-26,22,2597,172,178,0,251,556,3776
2023-07-25,22,2584,172,177,0,242,555,3752
2023-07-24,22,2562,173,176,0,235,559,3727
2023-07-21,22,2569,173,176,0,243,565,3748
2023-07-20,22,2571,173,175,0,237,563,3741
2023-07-19,22,2592,174,175,0,235,554,3752
2023-07-18,22,2594,174,175,0,225,555,3745
2023-07-17,22,2610,174,171,0,206,555,3738
2023-07-14,22,2614,174,175,0,199,562,3746
2023-07-13,22,2618,176,175,0,196,559,3746
2023-07-12,22,2616,176,175,0,169,559,3717
2023-07-11,24,2619,176,175,0,165,559,3718
2023-07-10,23,2624,176,176,0,149,550,3698
2023-07-07,24,2632,176,176,0,180,553,3741
2023-07-06,24,2624,175,176,0,202,556,3757
2023-07-05,24,2620,175,176,0,205,555,3755
2023-07-04,23,2619,175,175,0,211,560,3763
2023-07-03,23,2622,176,176,0,205,560,3762
2023-06-30,23,2626,181,182,0,289,565,3866
2023-06-29,23,2646,176,180,0,244,564,3833
2023-06-28,23,2644,176,180,0,248,564,3835
2023-06-27,23,2643,176,180,0,241,565,3828
2023-06-26,23,2646,176,175,0,230,570,3820
2023-06-23,23,2648,177,176,0,227,576,3827
2023-06-22,23,2657,177,176,0,220,584,3837
2023-06-21,23,2657,177,176,0,191,589,3813
2023-06-16,24,2669,177,180,0,188,583,3821
2023-06-15,24,2672,178,179,0,184,582,3819
2023-06-14,24,2672,179,179,0,179,587,3820
2023-06-13,27,2688,179,179,0,176,588,3837
2023-06-12,27,2679,180,180,0,159,587,3812
2023-06-09,24,2696,180,173,0,202,591,3866
2023-06-08,24,2687,180,173,0,233,587,3884
2023-06-07,24,2687,180,174,0,232,586,3883
2023-06-06,24,2690,180,174,0,235,586,3889
2023-06-05,24,2692,180,174,0,227,587,3884
2023-06-02,24,2694,180,175,0,276,587,3936
2023-06-01,24,2698,180,175,0,276,588,3941
2023-05-31,24,2689,186,182,0,319,585,3985
2023-05-30,24,2699,183,166,0,270,591,3933
2023-05-29,24,2712,184,166,0,249,598,3933
2023-05-24,25,2720,185,166,0,239,600,3935
2023-05-23,25,2721,185,167,0,237,602,3937
2023-05-22,25,2727,186,167,0,221,605,3931
2023-05-19,25,2735,186,168,0,214,610,3938
2023-05-18,25,2734,186,167,0,213,612,3937
2023-05-17,25,2736,186,167,0,206,609,3929
2023-05-16,25,2742,186,167,0,197,611,3928
2023-05-15,25,2748,186,169,0,179,615,3922
2023-05-12,25,2751,186,173,0,170,624,3929
2023-05-11,25,2750,186,173,0,162,618,3914
2023-05-10,25,2760,186,165,0,156,617,3909
2023-05-09,25,2765,186,165,0,152,617,3910
2023-05-08,25,2763,185,166,0,144,618,3901
2023-05-05,25,2769,185,165,0,172,632,3948
2023-05-04,25,2767,185,166,0,194,632,3969
2023-05-03,25,2765,186,165,0,190,628,3959
2023-05-02,25,2770,186,166,0,188,629,3964
2023-04-28,25,2772,186,172,0,245,632,4032
2023-04-27,25,2770,186,161,0,210,630,3982
2023-04-26,25,2761,187,162,0,210,630,3975
2023-04-25,25,2764,187,162,0,203,637,3978
2023-04-24,25,2752,187,162,0,192,636,3954
2023-04-21,25,2756,187,162,0,191,636,3957
2023-04-20,25,2755,188,162,0,186,639,3955
2023-04-19,25,2738,185,162,0,182,633,3925
2023-04-18,24,2734,185,162,0,175,632,3912
2023-04-17,24,2732,184,161,0,160,631,3892
2023-04-14,24,2631,185,162,0,153,614,3769
2023-04-13,24,2633,185,162,0,152,613,3769
2023-04-12,24,2604,185,162,0,149,614,3738
2023-04-11,24,2590,185,161,0,149,615,3724
2023-04-10,23,2529,185,163,0,136,597,3633
2023-04-05,23,2548,186,161,0,172,605,3695
2023-04-04,24,2565,186,160,0,182,592,3709
2023-04-03,29,2564,186,161,0,180,594,3714
2023-03-31,24,2573,185,158,0,232,596,3768
2023-03-30,24,2576,185,157,0,207,586,3735
2023-03-29,24,2576,186,156,0,212,583,3737
2023-03-28,24,2564,186,156,0,207,586,3723
2023-03-27,24,2520,184,155,0,193,591,3667
2023-03-23,23,2567,184,156,0,190,588,3708
2023-03-22,23,2563,185,156,0,189,590,3706
2023-03-21,23,2558,185,156,0,182,590,3694
2023-03-20,23,2565,185,157,0,168,593,3691
2023-03-17,23,2569,185,156,0,162,598,3693
2023-03-16,23,2560,185,156,0,163,595,3682
2023-03-15,22,2558,185,158,0,162,583,3668
2023-03-14,22,2526,185,158,0,163,587,3641
2023-03-13,22,2529,185,158,0,150,581,3625
2023-03-10,22,2524,185,158,0,195,582,3666
2023-03-09,22,2469,186,158,0,225,586,3646
2023-03-08,22,2473,186,154,0,234,580,3649
2023-03-07,22,2474,186,154,0,244,582,3662
2023-03-06,22,2450,186,154,0,235,569,3616
2023-03-03,23,2451,186,155,0,288,572,3675
2023-03-02,22,2446,186,156,0,285,568,3663
2023-03-01,22,2445,187,153,0,284,573,3664
2023-02-28,22,2444,187,157,0,306,567,3683
2023-02-27,22,2448,186,152,0,295,567,3670
2023-02-24,22,2449,187,152,0,278,582,3670
2023-02-23,22,2443,187,153,0,271,580,3656
2023-02-22,22,2432,188,153,0,253,583,3631
2023-02-17,22,2388,188,153,0,242,597,3590
2023-02-16,22,2388,188,154,0,241,591,3584
2023-02-15,22,2387,189,154,0,234,582,3568
2023-02-14,22,2388,189,154,0,227,582,3562
2023-02-13,22,2388,190,150,0,208,583,3541
2023-02-10,22,2393,190,151,0,199,585,3540
2023-02-09,22,2393,190,152,0,191,584,3532
2023-02-08,22,2383,190,152,0,185,581,3513
2023-02-07,22,2378,190,152,0,184,599,3525
2023-02-06,22,2376,190,152,0,178,600,3518
2023-02-03,21,2384,190,153,0,214,617,3579
2023-02-02,20,2397,190,150,0,235,637,3629
2023-02-01,20,2387,190,150,0,235,644,3626
2023-01-31,20,2367,191,156,0,278,643,3655
2023-01-30,19,2363,191,146,0,244,645,3608
2023-01-27,20,2338,191,150,0,245,647,3591
2023-01-26,20,2309,191,150,0,239,643,3552
2023-01-25,20,2299,192,150,0,238,640,3539
2023-01-24,19,2297,192,150,0,230,639,3527
2023-01-23,19,2295,192,150,0,223,638,3517
2023-01-20,19,2289,192,151,0,209,636,3496
2023-01-19,19,2313,192,151,0,203,631,3509
2023-01-18,19,2309,192,151,0,196,634,3501
2023-01-17,19,2309,192,149,0,183,629,3481
2023-01-16,20,2307,193,151,0,171,632,3474
2023-01-13,20,2308,193,154,0,164,632,3471
2023-01-12,19,2304,193,152,0,161,641,3470
2023-01-11,19,2297,193,152,0,157,638,3456
2023-01-10,19,2295,193,152,0,152,639,3450
2023-01-09,19,2292,193,152,0,133,643,3432
2023-01-06,19,2293,193,152,0,157,647,3461
2023-01-05,19,2293,193,151,0,170,646,3472
2023-01-04,19,2294,193,152,0,168,645,3471
2023-01-03,19,2293,193,151,0,166,641,3463
2023-01-02,19,2294,193,152,0,160,659,3477
2022-12-30,19,2318,201,149,0,179,660,3526
2022-12-29,19,2292,196,152,0,176,668,3503
2022-12-28,19,2291,196,152,0,177,665,3500
2022-12-27,19,2279,196,152,0,171,664,3481
2022-12-26,19,2272,196,150,0,168,658,3463
2022-12-23,20,2270,196,148,0,171,659,3464
2022-12-22,20,2270,197,148,0,168,660,3463
2022-12-21,20,2263,196,148,0,169,661,3457
2022-12-20,20,2262,197,148,0,164,656,3447
2022-12-19,20,2263,197,149,0,150,658,3437
2022-12-16,20,2272,197,152,0,150,660,3451
2022-12-15,20,2263,197,151,0,148,657,3436
2022-12-14,20,2266,199,153,0,146,672,3456
2022-12-13,20,2264,199,153,0,164,680,3480
2022-12-12,20,2268,199,151,0,150,688,3476
2022-12-07,19,2263,199,152,0,186,686,3505
2022-12-06,19,2269,199,152,0,182,678,3499
2022-12-05,20,2275,199,152,0,202,679,3527
2022-12-02,20,2273,199,153,0,243,682,3570
2022-12-01,20,2280,200,154,0,232,679,3565
2022-11-30,20,2288,199,154,0,236,679,3576
2022-11-29,20,2297,201,149,0,243,677,3587
2022-11-28,19,2293,201,150,0,225,681,3569
2022-11-25,20,2301,202,149,0,225,681,3578
2022-11-24,20,2294,202,148,0,221,686,3571
2022-11-23,20,2294,203,148,0,221,686,3572
2022-11-22,20,2289,203,149,0,206,694,3561
2022-11-18,20,2299,203,150,0,200,693,3565
2022-11-17,20,2300,203,151,0,199,694,3567
2022-11-16,20,2298,203,151,0,193,694,3559
2022-11-15,20,2298,203,151,0,187,699,3558
2022-11-14,20,2296,203,153,0,174,702,3548
2022-11-11,20,2291,203,153,0,173,698,3538
2022-11-10,20,2288,203,153,0,165,698,3527
2022-11-09,20,2300,203,151,0,162,706,3542
2022-11-08,20,2289,203,152,0,159,694,3517
2022-11-07,20,2283,204,149,0,148,701,3505
2022-11-04,20,2298,204,147,0,197,707,3573
2022-11-03,20,2302,204,147,0,217,702,3592
2022-11-02,21,2295,204,148,0,219,701,3588
2022-11-01,21,2299,204,147,0,222,697,3590
2022-10-31,21,2307,206,150,0,251,688,3623
2022-10-28,21,2295,204,144,0,265,674,3603
2022-10-27,21,2295,205,144,0,260,673,3598
2022-10-26,21,2283,204,143,0,265,667,3583
2022-10-25,21,2281,205,143,0,258,665,3573
2022-10-24,21,2280,205,143,0,252,675,3576
2022-10-21,21,2286,206,143,0,253,677,3586
2022-10-20,21,2281,206,144,0,248,677,3577
2022-10-19,21,2281,206,144,0,248,677,3577
2022-10-18,21,2279,206,144,0,238,676,3564
2022-10-17,21,2277,206,144,0,223,675,3546
2022-10-14,21,2280,206,146,0,217,681,3551
2022-10-13,21,2278,199,145,0,218,674,3535
2022-10-12,21,2281,199,146,0,217,666,3530
2022-10-11,21,2291,200,144,0,202,666,3524
2022-10-06,21,2302,201,144,0,258,664,3590
2022-10-05,23,2317,201,144,0,260,665,3610
2022-10-04,23,2335,199,145,0,263,664,3629
2022-10-03,23,2337,199,146,0,257,657,3619
2022-09-30,23,2335,209,146,0,289,658,3660
2022-09-29,23,2333,196,147,0,292,649,3640
2022-09-28,23,2358,196,146,0,294,637,3654
2022-09-27,23,2359,196,146,0,282,629,3635
2022-09-26,23,2343,197,143,0,270,629,3605
2022-09-23,24,2345,197,143,0,267,628,3604
2022-09-22,24,2344,197,143,0,260,626,3594
2022-09-21,24,2323,198,145,0,260,621,3571
2022-09-20,24,2328,198,145,0,249,617,3561
2022-09-19,24,2331,198,146,0,224,614,3537
2022-09-16,24,2330,199,146,0,216,611,3526
2022-09-15,24,2331,199,146,0,212,618,3530
2022-09-14,24,2329,199,150,0,204,618,3524
2022-09-13,33,2339,199,141,0,204,616,3532
2022-09-12,33,2339,199,142,0,188,607,3508
2022-09-09,33,2347,200,142,0,238,603,3563
2022-09-08,33,2351,200,142,0,277,597,3600
2022-09-07,33,2351,200,142,0,278,596,3600
2022-09-06,33,2355,200,142,0,281,595,3606
2022-09-05,33,2363,200,142,0,276,606,3620
2022-09-01,33,2367,200,144,0,330,604,3678
2022-08-31,33,2362,200,149,0,328,611,3683
2022-08-30,33,2370,201,144,0,338,624,3710
2022-08-29,33,2408,202,139,0,333,626,3741
2022-08-26,33,2414,203,143,0,322,642,3757
2022-08-25,33,2413,203,144,0,315,637,3745
2022-08-24,33,2413,203,145,0,314,635,3743
2022-08-23,34,2414,203,146,0,305,636,3738
2022-08-22,34,2415,203,148,0,288,633,3721
2022-08-19,34,2414,203,148,0,283,637,3719
2022-08-18,33,2415,203,148,0,282,634,3715
2022-08-17,33,2418,204,148,0,269,628,3700
2022-08-16,33,2427,204,150,0,250,620,3684
2022-08-12,33,2433,205,151,0,239,623,3684
2022-08-11,33,2453,205,156,0,230,623,3700
2022-08-10,33,2452,205,156,0,225,607,3678
2022-08-09,33,2452,205,160,0,219,607,3676
2022-08-08,33,2460,205,158,0,201,602,3659
2022-08-05,33,2463,205,159,0,237,600,3697
2022-08-04,34,2463,205,160,0,267,580,3709
2022-08-03,34,2480,205,160,0,264,585,3728
2022-08-02,34,2513,206,155,0,264,613,3785
2022-08-01,34,2522,206,155,0,258,604,3779
2022-07-29,34,2539,208,161,0,294,600,3836
2022-07-28,34,2549,210,157,0,298,599,3847
2022-07-27,34,2548,210,158,0,301,595,3846
2022-07-26,34,2550,209,159,0,289,599,3840
2022-07-25,34,2550,207,159,0,269,598,3817
2022-07-22,34,2569,207,160,0,264,599,3833
2022-07-21,34,2573,207,160,0,257,592,3823
2022-07-20,33,2574,207,161,0,253,579,3807
2022-07-19,33,2604,207,162,0,242,577,3825
2022-07-18,33,2606,207,164,0,217,574,3801
2022-07-15,33,2609,208,164,0,208,563,3785
2022-07-14,33,2612,208,165,0,208,563,3789
2022-07-13,33,2615,208,165,0,206,562,3789
2022-07-12,33,2623,208,170,0,202,561,3797
2022-07-11,33,2633,209,164,0,181,571,3791
2022-07-08,33,2634,209,165,0,217,571,3829
2022-07-07,33,2649,210,166,0,250,577,3885
2022-07-06,35,2646,213,166,0,252,575,3887
2022-07-05,33,2686,213,166,0,253,569,3920
2022-07-04,36,2707,213,167,0,254,573,3950
2022-07-01,36,2705,214,168,0,319,573,4015
2022-06-30,33,2703,214,172,0,305,568,3995
2022-06-29,33,2697,215,164,0,320,571,4000
2022-06-28,33,2681,216,165,0,312,571,3978
2022-06-27,33,2654,216,165,0,301,577,3946
2022-06-24,33,2657,216,170,0,297,570,3943
2022-06-23,33,2633,217,171,0,292,575,3921
2022-06-22,32,2636,217,172,0,289,571,3917
2022-06-21,32,2635,217,174,0,261,558,3877
2022-06-16,32,2636,218,179,0,255,540,3860
2022-06-15,23,2639,220,179,0,246,542,3849
2022-06-14,23,2637,225,185,0,237,557,3864
2022-06-13,23,2592,225,185,0,220,557,3802
2022-06-10,23,2581,226,186,0,209,548,3773
2022-06-09,23,2569,226,186,0,200,545,3749
2022-06-08,23,2550,226,187,0,193,543,3722
2022-06-07,23,2545,226,187,0,187,544,3712
2022-06-06,23,2541,226,188,0,169,542,3689
2022-06-03,24,2547,226,184,0,200,544,3725
2022-06-02,24,2547,227,184,0,230,544,3756
2022-06-01,24,2530,227,185,0,233,543,3742
2022-05-31,24,2491,224,183,0,257,537,3716
2022-05-30,24,2514,228,181,0,240,539,3726
2022-05-27,24,2521,229,188,0,250,542,3754
2022-05-26,24,2522,229,189,0,237,525,3726
2022-05-24,24,2519,229,189,0,237,522,3720
2022-05-23,24,2538,230,183,0,224,517,3716
2022-05-20,24,2546,231,184,0,214,524,3723
2022-05-19,24,2540,231,187,0,201,512,3695
2022-05-17,24,2539,230,188,0,199,512,3692
2022-05-16,24,2534,231,188,0,182,516,3675
2022-05-13,74,2530,231,189,0,177,512,3713
2022-05-12,74,2522,231,189,0,175,511,3702
2022-05-11,72,2515,231,189,0,169,511,3687
2022-05-10,72,2520,231,190,0,163,508,3684
2022-05-09,72,2527,231,186,0,145,508,3669
2022-05-06,72,2538,231,186,0,176,512,3715
2022-05-05,72,2529,231,186,0,202,513,3733
2022-05-04,72,2529,231,187,0,201,511,3731
2022-05-03,72,2524,231,187,0,201,497,3712
2022-05-02,72,2510,231,186,0,199,491,3689
2022-04-29,72,2507,231,189,0,228,487,3714
2022-04-28,72,2531,244,188,0,228,490,3753
2022-04-27,72,2535,244,185,0,230,490,3756
2022-04-26,72,2528,244,189,0,221,488,3742
2022-04-25,72,2522,245,192,0,211,488,3730
2022-04-22,72,2519,245,193,0,206,489,3724
2022-04-21,72,2513,246,192,0,199,489,3711
2022-04-20,72,2513,246,192,0,197,486,3706
2022-04-19,72,2518,246,193,0,189,527,3745
2022-04-18,72,2515,246,196,0,165,528,3722
2022-04-13,72,2527,246,196,0,159,603,3803
2022-04-12,74,2523,246,197,0,155,606,3801
2022-04-11,74,2517,246,197,0,138,609,3781
2022-04-08,74,2514,247,198,0,164,617,3814
2022-04-07,74,2511,247,198,0,188,611,3829
2022-04-06,74,2514,247,198,0,187,614,3834
2022-04-05,74,2515,246,199,0,187,613,3834
2022-04-04,74,2514,246,199,0,178,611,3822
2022-04-01,74,2507,247,200,0,204,611,3843
2022-03-31,74,2513,247,195,0,203,568,3800
2022-03-30,74,2531,247,197,0,216,610,3875
2022-03-29,74,2507,247,198,0,208,611,3845
2022-03-28,74,2504,248,198,0,195,618,3837
2022-03-25,74,2543,248,199,0,187,620,3871
2022-03-23,74,2538,249,200,0,178,620,3859
2022-03-22,74,2541,249,200,0,178,620,3862
2022-03-21,74,2543,249,197,0,161,623,3847
2022-03-18,74,2528,250,199,0,157,624,3832
2022-03-17,74,2520,250,199,0,159,625,3827
2022-03-16,74,2509,250,199,0,154,627,3813
2022-03-15,74,2502,250,201,0,153,627,3807
2022-03-14,74,2495,251,199,0,144,626,3789
2022-03-11,74,2490,251,199,0,197,626,3837
2022-03-10,74,2492,251,199,0,221,628,3865
2022-03-09,74,2485,251,200,0,221,628,3859
2022-03-08,74,2487,251,200,0,226,629,3867
2022-03-07,74,2488,251,200,0,226,628,3867
2022-03-04,75,2485,251,201,0,269,629,3910
2022-03-03,75,2465,252,201,0,262,629,3884
2022-03-02,75,2465,252,201,0,252,629,3874
2022-02-25,75,2471,252,202,0,241,629,3870
2022-02-24,75,2457,252,204,0,241,630,3859
2022-02-23,75,2457,252,206,0,244,634,3868
2022-02-22,75,2463,252,206,0,233,634,3863
2022-02-21,75,2465,252,206,0,219,633,3850
2022-02-18,75,2468,253,207,0,215,635,3853
2022-02-17,75,2469,253,208,0,212,635,3852
2022-02-16,75,2473,253,208,0,205,633,3847
2022-02-15,75,2468,254,208,0,197,634,3836
2022-02-14,75,2466,254,211,0,182,634,3822
2022-02-11,75,2471,255,213,0,175,638,3827
2022-02-10,75,2471,255,213,0,167,633,3814
2022-02-09,75,2471,255,213,0,161,634,3809
2022-02-08,75,2476,255,214,0,155,634,3809
2022-02-07,75,2480,255,214,0,140,638,3802
2022-02-04,75,2500,256,211,0,173,638,3853
2022-02-03,75,2497,256,212,0,186,640,3866
2022-02-02,75,2494,256,212,0,179,638,3854
2022-02-01,75,2496,256,212,0,184,642,3865
2022-01-31,75,2538,256,156,0,195,635,3855
2022-01-28,81,2512,257,215,0,194,637,3896
2022-01-27,81,2513,257,215,0,190,637,3893
2022-01-26,81,2512,257,215,0,189,638,3892
2022-01-25,81,2520,257,216,0,181,641,3896
2022-01-24,81,2521,257,217,0,166,642,3884
2022-01-21,81,2525,258,217,0,161,641,3883
2022-01-20,81,2529,258,223,0,155,640,3886
2022-01-19,81,2555,258,223,0,151,640,3908
2022-01-18,81,2560,258,223,0,139,642,3903
2022-01-17,81,2564,258,224,0,127,642,3896
2022-01-14,82,2567,259,224,0,122,656,3910
2022-01-13,82,2568,259,224,0,120,657,3910
2022-01-12,82,2569,259,225,0,117,657,3909
2022-01-11,82,2570,259,222,0,111,657,3901
2022-01-10,82,2565,260,224,0,99,659,3889
2022-01-07,82,2564,260,224,0,118,665,3913
2022-01-06,82,2567,261,224,0,127,664,3925
2022-01-05,82,2568,261,224,0,124,664,3923
2022-01-04,82,2573,261,225,0,124,665,3930
2022-01-03,82,2589,259,225,0,113,666,3934
2021-12-30,82,2606,260,224,0,139,668,3979
2021-12-29,82,2629,260,226,0,137,670,4004
2021-12-28,82,2640,261,227,0,132,676,4018
2021-12-27,82,2659,261,225,0,128,677,4032
2021-12-23,82,2686,262,229,0,124,677,4060
2021-12-22,82,2678,268,232,0,125,677,4062
2021-12-21,82,2692,268,232,0,120,677,4071
2021-12-20,82,2701,269,232,0,110,678,4072
2021-12-17,83,2703,269,233,0,107,680,4075
2021-12-16,83,2723,262,233,0,106,681,4088
2021-12-15,83,2729,263,237,0,105,683,4100
2021-12-14,85,2736,269,237,0,110,684,4121
2021-12-13,85,2754,269,238,0,108,683,4137
2021-12-10,85,2775,257,238,0,138,689,4182
2021-12-09,85,2793,257,238,0,151,691,4215
2021-12-07,85,2796,257,238,0,155,691,4222
2021-12-06,85,2805,257,239,0,154,690,4230
2021-12-03,86,2810,258,235,0,186,691,4266
2021-12-02,86,2826,258,236,0,182,690,4278
2021-12-01,86,2831,259,236,0,190,692,4294
2021-11-30,86,2849,260,237,0,192,694,4318
2021-11-29,86,2848,249,239,0,175,715,4312
2021-11-26,85,2858,249,239,0,177,716,4324
2021-11-25,86,2882,254,240,0,168,707,4337
2021-11-24,86,2891,254,240,0,169,714,4354
2021-11-23,86,2899,255,241,0,155,714,4350
2021-11-19,86,2951,255,246,0,149,726,4413
2021-11-18,86,2976,255,246,0,147,719,4429
2021-11-17,86,2978,255,248,0,141,721,4429
2021-11-16,86,2997,255,249,0,135,721,4443
2021-11-15,86,3004,255,243,0,124,720,4432
2021-11-12,86,3010,256,244,0,117,730,4443
2021-11-11,86,3018,257,244,4,113,730,4452
2021-11-10,86,3022,257,244,4,110,729,4452
2021-11-09,86,3031,257,245,4,106,736,4465
2021-11-08,86,3055,258,241,4,98,736,4478
2021-11-05,86,3064,258,241,4,115,740,4508
2021-11-04,86,3080,258,241,1,124,753,4543
2021-11-03,86,3100,258,241,1,120,753,4559
2021-11-02,86,3146,258,242,1,118,767,4618
2021-11-01,86,3156,258,240,1,115,758,4614
2021-10-29,86,3210,258,244,0,143,759,4700
2021-10-28,86,3214,259,241,1,131,764,4696
2021-10-27,86,3219,259,242,1,130,760,4697
2021-10-26,86,3231,259,243,1,125,763,4708
2021-10-25,86,3240,260,243,1,117,763,4710
2021-10-22,86,3247,260,244,1,116,761,4715
2021-10-21,86,3239,260,244,1,111,768,4709
2021-10-20,86,3243,261,244,1,111,760,4706
2021-10-19,86,3249,261,244,1,105,783,4729
2021-10-18,86,3231,261,245,0,96,732,4651
2021-10-15,86,3292,262,245,0,93,732,4710
2021-10-14,86,3294,262,251,0,90,732,4715
2021-10-13,86,3306,262,250,0,95,738,4737
2021-10-12,86,3311,263,255,0,89,732,4736
2021-10-07,87,3370,263,250,0,115,734,4819
2021-10-06,87,3399,263,251,0,111,732,4843
2021-10-05,87,3416,263,251,0,116,732,4865
2021-10-04,87,3419,264,251,0,117,754,4892
2021-10-01,87,3444,264,250,0,130,735,4910
2021-09-30,87,3449,264,250,0,129,788,4967
2021-09-29,87,3482,264,250,0,130,802,5015
2021-09-28,87,3493,265,251,0,126,784,5006
2021-09-27,87,3500,265,250,0,122,797,5021
2021-09-24,87,3501,265,251,0,121,780,5005
2021-09-23,87,3524,265,252,0,117,782,5027
2021-09-22,86,3549,266,252,0,116,780,5049
2021-09-21,86,3548,267,252,0,111,788,5052
2021-09-20,86,3558,267,253,0,102,789,5055
2021-09-17,86,3562,267,253,0,98,791,5057
2021-09-16,86,3573,267,255,0,94,791,5066
2021-09-15,86,3581,268,259,0,90,793,5077
2021-09-14,86,3602,268,263,0,86,804,5109
2021-09-13,86,3618,268,263,0,80,802,5117
2021-09-10,86,3625,268,261,0,76,812,5128
2021-09-09,86,3660,270,261,0,72,798,5147
2021-09-08,86,3654,270,262,0,69,797,5138
2021-09-07,86,3661,270,259,0,66,795,5137
2021-09-06,86,3656,270,259,0,65,796,5132
2021-09-03,86,3648,271,260,0,83,796,5144
2021-09-02,86,3660,271,261,0,81,808,5167
2021-09-01,87,3670,271,261,0,82,837,5208
2021-08-31,87,3700,271,260,0,98,800,5216
2021-08-30,87,3698,271,262,0,89,813,5220
2021-08-27,94,3695,272,263,0,93,820,5237
2021-08-26,87,3701,272,263,0,90,820,5233
2021-08-25,87,3704,273,264,0,91,825,5244
2021-08-24,87,3711,273,265,0,87,825,5248
2021-08-23,87,3717,273,266,0,82,830,5255
2021-08-20,88,3738,274,267,0,82,837,5286
2021-08-19,88,3737,275,267,0,77,872,5316
2021-08-18,89,3747,275,268,0,74,879,5332
2021-08-17,89,3747,275,269,0,69,850,5299
2021-08-13,89,3760,276,269,0,65,842,5301
2021-08-12,89,3807,277,277,0,64,849,5363
2021-08-11,89,3821,278,276,0,63,846,5373
2021-08-10,89,3828,278,277,0,61,838,5371
2021-08-09,89,3828,278,275,0,59,833,5362
2021-08-06,89,3829,278,275,0,78,835,5384
2021-08-05,89,3834,278,275,0,76,824,5376
2021-08-04,89,3860,278,276,0,75,820,5398
2021-08-03,89,3875,279,276,0,74,826,5419
2021-08-02,89,3811,279,275,0,71,790,5315
2021-07-30,89,3822,279,278,0,89,786,5343
2021-07-29,89,3812,267,277,0,84,799,5328
2021-07-28,89,3829,267,278,0,86,801,5350
2021-07-27,90,3825,267,279,0,83,800,5344
2021-07-26,90,3822,268,281,0,79,832,5372
2021-07-23,90,3822,268,282,0,78,864,5404
2021-07-22,89,3819,269,280,0,75,801,5333
2021-07-21,89,3818,269,282,0,74,804,5336
2021-07-20,89,3811,269,282,0,72,802,5325
2021-07-19,89,3850,270,289,0,66,821,5385
2021-07-16,89,3869,270,290,0,65,805,5388
2021-07-15,89,3842,270,290,0,62,817,5370
2021-07-14,89,3847,270,290,0,61,801,5358
2021-07-13,89,3828,271,290,0,63,806,5347
2021-07-12,89,3823,271,290,0,65,809,5347
2021-07-08,89,3837,271,291,0,87,814,5389
2021-07-07,89,3841,272,291,0,86,814,5393
2021-07-06,88,3813,272,291,0,85,814,5363
2021-07-05,89,3823,272,291,0,86,815,5376
2021-07-02,89,3812,273,292,0,102,827,5395
2021-07-01,89,3793,273,292,0,100,847,5394
2021-06-30,90,3806,264,293,0,111,817,5381
2021-06-29,90,3756,264,297,0,103,839,5349
2021-06-28,90,3754,265,296,0,97,834,5336
2021-06-25,90,3776,266,297,0,97,819,5345
2021-06-24,91,3776,266,298,0,93,855,5379
2021-06-23,91,3784,266,298,0,93,835,5367
2021-06-22,91,3800,267,299,0,86,824,5367
2021-06-18,91,3803,267,300,0,83,826,5370
2021-06-17,91,3809,268,301,0,80,848,5397
2021-06-16,91,3772,268,301,0,77,828,5337
2021-06-15,91,3770,270,307,0,71,827,5336
2021-06-14,91,3769,276,307,0,67,850,5360
2021-06-11,91,3779,277,308,0,63,877,5395
2021-06-10,91,3781,277,308,0,60,829,5346
2021-06-09,91,3777,277,309,0,59,837,5350
2021-06-08,92,3872,277,309,0,57,837,5444
2021-06-07,92,3915,277,309,0,54,836,5483
2021-06-04,92,4007,278,309,0,67,843,5596
2021-06-03,91,4009,278,309,0,65,827,5579
2021-06-02,91,4025,278,310,0,65,827,5596
2021-06-01,91,4027,278,308,0,63,831,5598
2021-05-31,91,4006,278,311,0,75,825,5586
2021-05-28,92,3990,279,310,0,71,829,5571
2021-05-27,92,3976,279,310,0,69,837,5563
2021-05-26,92,3956,280,311,0,65,849,5553
2021-05-21,92,3954,280,312,0,62,843,5543
2021-05-20,92,3966,281,312,0,60,837,5548
2021-05-19,92,3960,281,313,0,59,839,5544
2021-05-18,93,3982,281,314,0,56,839,5565
2021-05-17,93,3962,281,317,0,51,867,5571
2021-05-14,93,3937,281,317,0,49,870,5547
2021-05-13,93,3962,281,318,0,46,844,5544
2021-05-12,93,3983,282,318,0,45,842,5563
2021-05-11,91,3972,282,318,0,44,841,5548
2021-05-10,91,3962,283,317,0,49,840,5542
2021-05-07,93,3961,284,318,0,53,833,5542
2021-05-06,93,3937,284,318,0,52,830,5514
2021-05-05,91,3932,284,318,0,51,828,5504
2021-05-04,91,3922,284,318,0,71,831,5517
2021-05-03,91,3893,284,315,0,69,834,5486
2021-04-30,91,3878,284,320,0,63,828,5464
2021-04-29,91,3868,284,317,0,77,830,5467
2021-04-28,91,3874,284,318,0,78,831,5476
2021-04-27,91,3881,283,318,0,76,841,5490
2021-04-26,91,3865,283,319,0,74,849,5481
2021-04-23,91,3836,285,319,0,73,840,5444
2021-04-22,91,3839,285,320,0,71,822,5428
2021-04-21,91,3827,285,320,0,71,824,5418
2021-04-20,91,3807,286,321,0,69,825,5399
2021-04-19,92,3794,286,323,0,65,825,5385
2021-04-16,92,3800,286,324,0,64,823,5389
2021-04-15,93,3791,286,323,0,62,833,5388
2021-04-14,93,3789,286,323,0,61,855,5407
2021-04-13,93,3783,287,323,0,60,848,5394
2021-04-12,93,3747,287,323,0,61,816,5327
2021-04-09,93,3746,287,324,0,52,826,5328
2021-04-08,93,3727,288,324,0,50,826,5308
2021-04-07,93,3719,288,324,0,50,822,5296
2021-04-06,93,3691,288,325,0,71,819,5287
2021-04-05,93,3686,288,325,0,67,819,5278
2021-03-31,93,3661,288,327,0,59,826,5254
2021-03-30,93,3605,288,325,0,80,856,5247
2021-03-29,92,3592,289,322,0,78,874,5247
2021-03-26,92,3619,289,323,0,77,842,5242
2021-03-25,92,3608,289,324,0,73,829,5215
2021-03-23,92,3557,290,325,0,75,837,5176
2021-03-22,93,3518,290,325,0,70,839,5135
2021-03-19,93,3490,291,326,0,69,830,5099
2021-03-18,93,3472,291,327,0,67,832,5082
2021-03-17,93,3453,289,330,0,65,839,5069
2021-03-16,93,3441,290,330,0,65,834,5053
2021-03-15,93,3421,290,336,0,66,834,5040
2021-03-12,93,3411,290,337,0,85,835,5051
2021-03-11,92,3406,290,337,0,85,859,5069
2021-03-10,93,3389,290,337,0,86,837,5032
2021-03-09,93,3387,290,338,0,87,837,5032
2021-03-08,93,3381,290,338,0,87,851,5040
2021-03-05,93,3379,291,339,0,102,853,5057
2021-03-04,93,3390,291,339,0,100,857,5070
2021-03-03,93,3388,291,339,0,82,857,5050
2021-03-02,93,3386,291,340,0,75,859,5044
2021-03-01,93,3393,291,333,0,94,861,5065
2021-02-26,95,3404,294,335,0,82,860,5070
2021-02-25,94,3400,292,337,0,96,864,5083
2021-02-24,94,3390,292,338,0,97,845,5056
2021-02-23,94,3401,292,339,0,95,857,5078
2021-02-22,94,3389,292,340,0,91,851,5057
2021-02-19,95,3398,293,340,0,91,853,5070
2021-02-18,94,3389,293,341,0,87,856,5060
2021-02-17,94,3371,293,339,0,80,857,5034
2021-02-12,94,3371,294,341,0,76,857,5033
2021-02-11,94,3377,294,341,0,73,858,5037
2021-02-10,94,3376,294,341,0,72,858,5035
2021-02-09,95,3369,294,342,0,71,859,5030
2021-02-08,95,3373,294,342,0,72,880,5056
2021-02-05,95,3376,294,343,0,88,859,5055
2021-02-04,95,3372,294,343,0,65,857,5026
2021-02-03,95,3368,292,344,0,64,855,5018
2021-02-02,95,3365,293,344,0,83,867,5047
2021-02-01,95,3374,293,335,0,82,849,5028
2021-01-29,96,3395,296,345,0,79,860,5071
2021-01-28,94,3399,296,337,0,92,867,5085
2021-01-27,94,3407,296,341,0,94,866,5098
2021-01-26,94,3409,296,341,0,94,848,5082
2021-01-25,94,3403,296,341,0,89,850,5073
2021-01-22,94,3405,296,343,5,90,850,5083
2021-01-21,98,3414,298,343,5,88,832,5078
2021-01-20,98,3413,298,344,5,87,832,5077
2021-01-19,99,3438,298,349,5,84,833,5106
2021-01-18,99,3443,298,349,5,79,853,5126
2021-01-15,99,3447,298,351,5,78,829,5107
2021-01-14,99,3455,298,348,5,76,850,5131
2021-01-13,99,3463,299,348,5,75,843,5132
2021-01-12,99,3475,299,349,5,76,844,5147
2021-01-11,99,3489,300,349,5,55,853,5150
2021-01-08,99,3525,300,350,5,72,846,5197
2021-01-07,100,3526,300,351,5,72,846,5200
2021-01-06,100,3534,300,351,5,71,846,5207
2021-01-05,100,3540,300,352,5,93,852,5242
2021-01-04,100,3586,301,363,5,95,852,5302
2020-12-30,101,3590,302,357,5,90,868,5313
2020-12-29,106,3598,302,360,5,109,873,5353
2020-12-28,106,3567,303,361,5,107,874,5323
2020-12-23,106,3520,304,363,5,108,873,5279
2020-12-22,106,3528,304,363,5,105,878,5289
2020-12-21,106,3533,307,370,5,102,881,5304
2020-12-18,107,3538,308,370,5,101,881,5310
2020-12-17,107,3541,308,370,5,99,883,5313
2020-12-16,107,3545,310,373,5,96,898,5334
2020-12-15,107,3565,310,373,5,93,917,5370
2020-12-14,107,3554,326,377,5,86,903,5358
2020-12-11,107,3547,327,378,5,85,902,5351
2020-12-10,107,3566,316,375,5,105,908,5382
2020-12-09,108,3575,316,375,5,101,909,5389
2020-12-04,108,3577,316,377,5,71,904,5358
2020-12-03,109,3584,316,376,5,70,945,5405
2020-12-02,107,3575,317,376,5,67,947,5394
2020-12-01,107,3576,317,377,5,108,947,5437
2020-11-30,110,3580,317,377,5,78,946,5413
2020-11-27,108,3588,318,372,5,117,981,5489
2020-11-26,107,3596,316,376,5,114,985,5499
2020-11-25,108,3598,316,378,5,115,991,5511
2020-11-24,108,3607,316,379,5,109,990,5514
2020-11-20,108,3649,316,381,5,109,994,5562
2020-11-19,108,3651,320,381,5,106,981,5552
2020-11-18,108,3657,320,381,5,106,987,5564
2020-11-17,108,3658,320,382,5,103,988,5564
2020-11-16,108,3669,320,385,5,99,989,5575
2020-11-13,108,3673,321,386,5,97,996,5586
2020-11-12,108,3674,321,387,5,94,997,5586
2020-11-11,108,3674,321,386,5,93,998,5585
2020-11-10,108,3683,321,383,5,93,998,5591
2020-11-09,108,3688,322,384,5,91,998,5596
2020-11-05,108,3700,322,383,5,103,1001,5622
2020-11-04,108,3701,322,383,5,58,1002,5579
2020-11-03,108,3706,323,384,5,99,1003,5628
2020-11-02,108,3708,323,379,5,99,1003,5625
2020-10-30,110,3705,323,386,5,69,989,5587
2020-10-29,109,3709,323,383,5,105,1012,5646
2020-10-28,107,3714,323,384,5,108,1010,5651
2020-10-27,107,3730,325,384,5,105,1011,5667
2020-10-26,107,3734,326,385,5,103,1013,5673
2020-10-23,107,3760,326,386,5,104,1013,5701
2020-10-22,107,3787,326,386,5,102,1017,5730
2020-10-21,108,3792,328,388,5,102,1018,5741
2020-10-20,108,3799,328,388,5,99,1019,5746
2020-10-19,108,3796,328,393,5,96,1018,5744
2020-10-16,108,3823,329,393,5,95,1020,5773
2020-10-15,108,3830,329,394,5,94,1020,5780
2020-10-14,108,3841,330,393,5,93,1021,5791
2020-10-13,108,3849,330,393,5,92,1021,5798
2020-10-09,108,3860,330,394,5,112,1029,5838
2020-10-08,110,3883,330,394,5,112,1030,5864
2020-10-07,109,3893,330,393,5,115,1029,5874
2020-10-06,110,3902,331,393,5,73,1031,5845
2020-10-05,115,3914,331,393,5,72,1031,5861
2020-10-02,115,3932,331,394,5,136,1032,5945
2020-10-01,115,3956,331,395,5,133,1037,5972
2020-09-30,117,3938,331,397,5,104,1022,5914
2020-09-29,115,3979,331,396,5,135,1046,6007
2020-09-28,116,3982,334,392,5,137,1050,6016
2020-09-25,116,4020,334,394,5,140,1053,6062
2020-09-24,116,4025,334,396,5,141,1057,6074
2020-09-23,116,4028,334,397,5,143,1057,6080
2020-09-22,116,4000,335,397,5,141,1057,6051
2020-09-21,116,4004,335,397,5,138,1057,6052
2020-09-18,116,4015,336,398,5,137,1057,6064
2020-09-17,116,4021,336,402,5,133,1058,6071
2020-09-16,116,4045,336,403,5,129,1060,6094
2020-09-15,117,4062,337,403,5,125,1062,6111
2020-09-14,111,4082,337,404,5,119,1068,6126
2020-09-11,117,4092,337,403,5,116,1078,6148
2020-09-10,118,4096,338,405,5,113,1081,6156
2020-09-09,118,4102,339,405,5,111,1082,6162
2020-09-08,118,4108,340,405,5,110,1088,6174
2020-09-07,119,4094,340,406,5,110,1095,6169
2020-09-04,119,4100,340,407,5,79,1096,6146
2020-09-03,119,4112,341,407,5,78,1100,6162
2020-09-02,119,4119,341,407,5,75,1100,6166
2020-09-01,119,4131,340,408,5,118,1100,6221
2020-08-31,120,4108,341,407,5,91,1081,6153
2020-08-28,169,4130,345,405,5,125,1122,6301
2020-08-27,169,4133,345,406,5,121,1123,6302
2020-08-26,169,4145,345,407,5,123,1124,6318
2020-08-25,179,4151,345,408,5,120,1124,6332
2020-08-24,179,4164,341,408,5,116,1127,6340
2020-08-21,179,4182,342,409,5,117,1128,6362
2020-08-20,179,4186,342,410,5,114,1129,6365
2020-08-19,179,4202,343,418,5,113,1130,6390
2020-08-18,179,4222,343,418,5,108,1141,6416
2020-08-14,179,4295,343,416,5,105,1098,6441
2020-08-13,179,4319,344,416,5,102,1098,6463
2020-08-12,179,4362,344,418,5,100,1097,6505
2020-08-11,179,4372,345,418,5,98,1098,6515
2020-08-10,189,4378,346,419,5,96,1099,6532
2020-08-07,189,4408,346,419,5,71,1100,6538
2020-08-06,189,4424,346,420,5,70,1100,6554
2020-08-05,189,4430,347,420,5,71,1101,6563
2020-08-04,189,4437,347,420,5,70,1101,6569
2020-08-03,189,4432,347,415,5,105,1103,6596
2020-07-31,190,4444,347,421,5,87,1086,6580
2020-07-30,189,4478,348,417,5,119,1112,6668
2020-07-29,189,4526,348,417,5,120,1130,6735
2020-07-28,189,4547,348,418,5,116,1131,6754
2020-07-27,189,4551,348,419,5,110,1132,6754
2020-07-24,189,4568,349,420,5,115,1131,6777
2020-07-23,189,4587,349,420,5,113,1132,6795
2020-07-22,189,4607,349,421,5,113,1134,6818
2020-07-21,190,4622,349,422,5,110,1133,6831
2020-07-20,205,4640,350,422,5,105,1135,6862
2020-07-17,205,4663,350,424,5,104,1137,6888
2020-07-16,205,4688,348,425,5,101,1136,6908
2020-07-15,205,4705,350,431,5,100,1138,6934
2020-07-14,205,4740,351,432,5,99,1138,6970
2020-07-13,205,4770,352,431,5,96,1140,6999
2020-07-08,205,4828,352,432,5,108,1176,7106
2020-07-07,206,4846,352,432,5,109,1180,7130
2020-07-06,206,4867,352,433,5,110,1181,7154
2020-07-03,207,4882,352,434,5,91,1182,7153
2020-07-02,207,4903,352,434,5,124,1186,7211
2020-07-01,207,4914,351,435,5,125,1188,7225
2020-06-30,208,4892,348,435,5,96,1173,7157
2020-06-29,207,4995,349,429,5,118,1183,7286
2020-06-26,207,5026,348,431,5,119,1181,7317
2020-06-25,207,5051,349,433,5,116,1184,7345
2020-06-24,219,5084,350,435,5,117,1185,7395
2020-06-23,219,5093,350,437,5,105,1189,7398
2020-06-22,220,5121,351,442,5,102,1203,7444
2020-06-19,221,5168,351,443,5,99,1203,7490
2020-06-18,221,5174,353,444,5,97,1206,7500
2020-06-17,221,5213,355,444,5,94,1206,7538
2020-06-16,221,5234,357,445,5,91,1207,7560
2020-06-12,221,5274,359,446,5,88,1217,7610
2020-06-11,221,5303,360,447,5,86,1209,7631
2020-06-10,223,5316,361,447,5,85,1210,7647
2020-06-09,223,5331,361,449,5,83,1211,7663
2020-06-08,223,5361,361,449,5,83,1210,7692
2020-06-05,223,5371,361,450,5,56,1212,7678
2020-06-04,223,5401,361,451,5,55,1212,7708
2020-06-03,223,5406,362,451,5,54,1214,7715
2020-06-02,224,5428,362,445,5,52,1214,7730
2020-06-01,224,5453,362,445,5,82,1216,7787
2020-05-29,224,5449,362,452,5,54,1200,7746
2020-05-28,224,5506,362,452,5,88,1222,7859
2020-05-27,224,5548,362,451,5,90,1210,7890
2020-05-26,224,5573,362,452,5,87,1211,7914
2020-05-22,225,5590,362,459,5,89,1212,7942
2020-05-21,227,5594,362,460,5,88,1222,7958
2020-05-20,227,5639,363,461,5,89,1224,8008
2020-05-19,227,5672,363,459,5,87,1224,8037
2020-05-18,226,5678,363,460,5,86,1224,8042
2020-05-15,227,5693,363,487,5,84,1225,8084
2020-05-14,227,5702,363,487,5,84,1229,8097
2020-05-13,227,5719,363,488,5,83,1233,8118
2020-05-12,227,5750,363,489,5,81,1233,8148
2020-05-11,227,5773,364,489,5,81,1234,8173
2020-05-08,228,5801,364,490,5,55,1234,8177
2020-05-07,228,5832,365,491,5,57,1236,8214
2020-05-06,228,5844,365,491,5,58,1237,8228
2020-05-05,228,5861,365,492,5,89,1238,8278
2020-05-04,228,5873,365,478,5,88,1236,8273
2020-04-30,228,5905,365,465,5,69,1218,8255
2020-04-29,226,5956,368,482,5,115,1241,8393
2020-04-28,227,6004,367,488,5,115,1239,8445
2020-04-27,227,6024,367,488,5,114,1246,8471
2020-04-24,227,6051,367,489,5,121,1247,8507
2020-04-23,227,6072,368,490,5,121,1251,8534
2020-04-22,227,6117,368,490,5,121,1250,8578
2020-04-21,227,6116,369,491,5,121,1250,8579
2020-04-20,227,6156,369,492,5,118,1256,8623
2020-04-17,227,6204,369,494,5,118,1265,8682
2020-04-16,227,6236,370,495,5,117,1267,8717
2020-04-15,227,6243,370,496,5,116,1268,8725
2020-04-14,222,6322,370,470,5,124,1253,8766
2020-04-13,227,6317,371,472,5,125,1261,8778
2020-04-08,227,6390,371,472,5,145,1274,8884
2020-04-07,225,6372,371,472,5,147,1276,8868
2020-04-06,225,6398,372,473,5,147,1280,8900
2020-04-03,222,6417,372,473,5,147,1283,8919
2020-04-02,224,6421,373,475,5,145,1265,8908
2020-04-01,224,6447,373,476,5,146,1295,8966
2020-03-30,224,6472,373,476,5,110,1278,8938
2020-03-27,224,6482,373,469,5,148,1301,9002
2020-03-26,224,6482,373,470,5,148,1300,9002
2020-03-25,224,6508,374,474,5,146,1299,9030
2020-03-20,224,6542,374,475,5,149,1309,9078
2020-03-19,224,6566,374,476,5,148,1314,9107
2020-03-18,224,6583,374,477,5,149,1285,9097
2020-03-17,224,6639,374,478,5,148,1289,9157
2020-03-16,224,6672,375,479,5,144,1289,9188
2020-03-13,227,6715,375,479,5,144,1292,9237
2020-03-12,227,6738,376,480,5,141,1293,9260
2020-03-11,227,6883,376,481,5,140,1294,9406
2020-03-10,228,6910,376,485,5,142,1290,9436
2020-03-09,228,6931,376,480,5,145,1293,9458
2020-03-06,228,6946,377,481,5,175,1293,9505
2020-03-05,228,6954,377,481,5,175,1293,9513
2020-03-04,230,6953,377,477,5,148,1294,9484
2020-03-03,230,6960,377,478,5,179,1294,9523
2020-03-02,230,6993,377,469,5,179,1284,9537
2020-02-28,230,6983,378,471,5,167,1266,9500
2020-02-27,221,7015,378,472,5,196,1297,9584
2020-02-26,221,7041,378,473,5,190,1295,9603
2020-02-21,221,7084,378,474,5,191,1298,9651
2020-02-20,222,7095,378,474,5,186,1295,9655
2020-02-19,220,7149,379,474,5,183,1288,9698
2020-02-18,221,7158,379,473,5,175,1292,9703
2020-02-17,221,7157,379,481,5,166,1304,9713
2020-02-14,222,7160,380,482,5,164,1307,9720
2020-02-13,222,7192,378,482,5,160,1308,9747
2020-02-12,222,7162,378,474,5,155,1309,9705
2020-02-11,222,7181,378,479,5,155,1309,9729
2020-02-10,224,7218,378,480,5,155,1313,9773
2020-02-07,226,7225,378,481,5,190,1314,9819
2020-02-06,227,7249,378,482,5,191,1351,9883
2020-02-05,224,7246,378,483,5,159,1351,9846
2020-02-04,227,7243,379,483,5,186,1351,9874
2020-02-03,229,7234,379,486,5,190,1352,9875
2020-01-31,228,7255,379,488,5,193,1311,9859
2020-01-30,228,7279,380,489,5,223,1318,9922
2020-01-29,228,7279,380,488,5,226,1314,9920
2020-01-28,229,7302,380,488,5,224,1316,9944
2020-01-27,229,7297,381,489,5,215,1317,9933
2020-01-24,229,7292,381,489,5,218,1318,9932
2020-01-23,229,7326,380,489,5,213,1317,9959
2020-01-22,229,7334,380,489,5,211,1316,9964
2020-01-21,233,7340,381,489,5,204,1322,9974
2020-01-20,233,7400,381,489,5,198,1319,10025
2020-01-17,235,7413,381,494,5,198,1321,10047
2020-01-16,235,7428,382,494,5,194,1324,10062
2020-01-15,235,7414,382,494,5,186,1322,10038
2020-01-14,235,7386,382,492,5,175,1317,9992
2020-01-13,236,7400,382,486,5,173,1312,9994
2020-01-10,236,7423,383,489,5,172,1315,10023
2020-01-09,236,7425,383,489,5,168,1313,10019
2020-01-08,238,7452,375,489,5,152,1316,10027
2020-01-07,239,7493,376,489,5,160,1317,10079
2020-01-06,245,7542,378,484,5,198,1310,10162
2020-01-03,245,7566,378,484,5,255,1309,10242
2020-01-02,246,7618,379,484,5,267,1297,10296
2019-12-30,246,7627,379,485,5,267,1305,10314
2019-12-27,248,7695,380,490,5,316,1311,10445
2019-12-26,249,7720,382,491,5,299,1318,10464
2019-12-23,252,7787,382,490,5,272,1320,10508
2019-12-20,253,7825,382,491,5,266,1327,10549
2019-12-19,253,7878,382,492,5,256,1323,10589
2019-12-18,253,7823,383,492,5,250,1333,10539
2019-12-17,254,7875,384,492,5,236,1336,10582
2019-12-16,254,7875,385,495,5,222,1336,10572
2019-12-13,255,7935,386,495,5,221,1349,10646
2019-12-12,257,7971,394,496,5,207,1351,10681
2019-12-11,257,8000,384,488,5,201,1352,10687
2019-12-10,259,8091,385,479,5,200,1355,10774
2019-12-09,261,8113,385,479,5,209,1356,10808
2019-12-06,263,8164,386,480,5,261,1343,10902
2019-12-05,265,8193,386,480,5,237,1351,10917
2019-12-04,265,8221,386,480,5,233,1351,10941
2019-12-03,265,8234,386,480,5,251,1350,10971
2019-12-02,266,8247,386,491,5,248,1350,10993
2019-11-29,266,8276,387,499,5,252,1355,11040
2019-11-28,266,8325,387,499,5,280,1363,11125
2019-11-27,266,8371,388,498,5,281,1360,11169
2019-11-26,268,8443,388,499,5,265,1364,11232
2019-11-25,271,8469,391,499,5,248,1374,11257
2019-11-22,266,8496,391,496,5,252,1383,11289
2019-11-21,269,8559,392,497,5,245,1383,11350
2019-11-20,278,8588,392,499,5,240,1385,11387
2019-11-19,279,8615,391,499,5,217,1382,11388
2019-11-15,279,8617,391,499,5,212,1386,11389
2019-11-14,279,8631,391,499,5,206,1396,11407
2019-11-13,280,8638,391,499,5,200,1393,11406
2019-11-12,281,8661,389,496,5,200,1396,11428
2019-11-11,279,8708,389,481,5,215,1402,11479
2019-11-08,281,8733,389,482,5,270,1403,11563
2019-11-07,281,8765,390,482,5,268,1411,11602
2019-11-05,284,8813,390,482,5,278,1412,11664
2019-11-04,284,8850,390,478,5,281,1415,11703
2019-11-01,285,8907,390,478,5,330,1412,11807
2019-10-31,284,8933,390,481,5,301,1446,11840
2019-10-30,285,8992,389,479,5,329,1422,11901
2019-10-29,282,9066,386,480,5,321,1415,11955
2019-10-28,286,9135,386,479,5,306,1402,11999
2019-10-25,286,9162,387,477,5,317,1403,12037
2019-10-24,290,9279,387,481,5,311,1403,12156
2019-10-23,293,9404,387,483,5,309,1418,12299
2019-10-22,295,9481,387,485,5,301,1427,12381
2019-10-21,299,9567,387,487,5,286,1428,12459
2019-10-18,300,9615,387,487,5,284,1433,12511
2019-10-17,300,9693,387,487,5,275,1432,12579
2019-10-16,301,9737,388,488,5,264,1439,12622
2019-10-15,302,9788,388,490,5,309,1436,12718
2019-10-11,302,9894,388,490,5,228,1446,12753
2019-10-10,302,10012,389,490,5,221,1450,12869
2019-10-09,301,10049,389,490,5,213,1446,12893
2019-10-08,302,10125,389,493,5,213,1445,12972
2019-10-07,303,10222,384,487,5,220,1448,13069
2019-10-04,305,10310,384,487,5,263,1447,13201
2019-10-03,306,10354,384,487,5,261,1444,13241
2019-10-02,305,10406,385,480,5,265,1438,13284
2019-10-01,306,10466,385,482,5,268,1449,13361
2019-09-30,307,10488,385,500,5,263,1459,13407
2019-09-27,316,10680,384,502,5,283,1449,13619
2019-09-26,314,10766,384,504,5,274,1452,13699
2019-09-25,314,10814,385,505,5,281,1451,13755
2019-09-24,314,10875,380,506,5,271,1452,13803
2019-09-23,318,10916,380,506,5,260,1457,13842
2019-09-20,321,10980,381,507,5,255,1459,13908
2019-09-19,321,11043,381,508,5,249,1465,13972
2019-09-18,320,11079,381,508,5,251,1465,14009
2019-09-17,321,11196,381,509,5,241,1465,14118
2019-09-16,323,11266,376,511,5,222,1465,14168
2019-09-13,329,11366,377,512,5,220,1477,14286
2019-09-12,334,11437,377,512,5,214,1482,14361
2019-09-11,335,11550,376,512,5,210,1483,14471
2019-09-10,337,11626,376,498,5,214,1489,14545
2019-09-09,337,11736,377,490,5,214,1501,14660
2019-09-06,339,11834,377,489,5,246,1516,14806
2019-09-05,343,12023,377,489,5,235,1523,14995
2019-09-04,347,12082,377,489,5,234,1525,15059
2019-09-03,348,12145,377,490,5,251,1559,15175
2019-09-02,344,12352,377,483,5,262,1579,15402
2019-08-30,341,12344,377,482,5,268,1585,15402
2019-08-29,352,12444,375,469,5,289,1597,15531
2019-08-28,351,12510,380,469,5,301,1610,15626
2019-08-27,355,12545,377,482,5,299,1613,15676
2019-08-26,357,12586,377,423,5,290,1616,15654
2019-08-23,358,12638,378,423,5,297,1617,15716
2019-08-22,359,12692,373,425,5,291,1610,15755
2019-08-21,359,12748,373,425,5,298,1612,15820
2019-08-20,365,12827,370,423,5,278,1609,15877
2019-08-16,379,12980,371,422,5,278,1587,16022
2019-08-15,377,13029,371,421,5,277,1589,16069
2019-08-14,377,12999,371,412,5,276,1591,16031
2019-08-13,374,12992,371,423,5,288,1597,16050
2019-08-12,375,13035,372,423,5,292,1599,16101
2019-08-09,365,13078,372,479,5,350,1598,16247
2019-08-08,370,13109,371,480,5,353,1599,16287
2019-08-07,370,13074,371,477,5,356,1588,16241
2019-08-06,381,13092,371,479,5,344,1587,16259
2019-08-05,381,13089,371,478,5,365,1581,16270
2019-08-02,381,13020,371,484,5,412,1582,16255
2019-08-01,382,13078,370,487,5,403,1586,16311
2019-07-31,385,13029,371,488,5,394,1586,16258
2019-07-30,387,13032,370,489,5,399,1581,16263
2019-07-29,387,13024,370,486,5,381,1558,16211
2019-07-26,388,13029,366,488,5,387,1558,16221
2019-07-25,389,13012,367,487,5,376,1552,16188
2019-07-24,386,12994,367,491,5,376,1555,16174
2019-07-23,382,12979,367,493,5,365,1560,16151
2019-07-22,383,12997,367,497,5,342,1566,16157
2019-07-19,385,12984,366,498,5,337,1560,16135
2019-07-18,383,12975,365,498,5,326,1552,16104
2019-07-17,383,12952,365,497,5,315,1542,16059
2019-07-16,394,12908,368,494,5,303,1543,16015
2019-07-15,396,12888,366,500,5,284,1542,15981
2019-07-12,402,12887,365,501,5,272,1547,15979
2019-07-11,402,12890,365,499,5,288,1537,15986
2019-07-10,405,12861,364,502,5,283,1537,15957
2019-07-05,407,12827,364,506,5,300,1545,15954
2019-07-04,409,12794,364,510,5,299,1540,15921
2019-07-03,409,12755,366,506,5,293,1554,15888
2019-07-02,410,12730,364,503,5,298,1510,15820
2019-07-01,409,12672,364,506,5,296,1520,15772
2019-06-28,409,12667,361,489,5,313,1517,15761
2019-06-27,405,12668,361,496,5,314,1524,15773
2019-06-26,406,12658,362,500,5,324,1525,15780
2019-06-25,406,12515,362,503,5,313,1550,15654
2019-06-24,407,12495,363,515,5,292,1547,15624
2019-06-21,407,12441,364,513,5,286,1554,15570
2019-06-19,406,12496,364,509,5,277,1546,15603
2019-06-18,406,12473,365,506,5,260,1540,15555
2019-06-14,406,12498,364,505,5,249,1542,15569
2019-06-13,406,12522,364,510,5,257,1547,15611
2019-06-12,402,12513,365,509,5,255,1548,15597
2019-06-11,404,12542,365,498,5,269,1547,15630
2019-06-10,403,12489,366,494,5,263,1550,15570
2019-06-07,404,12495,366,495,5,283,1551,15599
2019-06-06,407,12521,366,490,5,281,1569,15639
2019-06-05,405,12525,366,494,5,278,1570,15643
2019-06-04,405,12545,366,494,5,285,1572,15672
2019-06-03,405,12559,364,492,5,285,1572,15682
2019-05-31,405,12549,364,486,5,298,1572,15679
2019-05-30,403,12587,365,490,5,311,1580,15741
2019-05-29,396,12618,362,492,5,312,1570,15755
2019-05-28,396,12678,362,490,5,303,1565,15799
2019-05-27,396,12696,362,484,5,286,1571,15800
2019-05-24,374,12712,362,483,5,293,1572,15801
2019-05-23,374,12812,363,481,5,286,1573,15894
2019-05-22,373,12780,363,484,5,289,1529,15823
2019-05-21,373,12779,363,483,5,278,1527,15808
2019-05-20,373,12802,363,480,5,258,1529,15810
2019-05-17,375,12813,363,482,5,255,1529,15822
2019-05-16,374,12840,363,483,5,263,1530,15858
2019-05-15,374,12857,363,481,5,262,1568,15910
2019-05-14,373,12855,364,481,5,283,1579,15940
2019-05-13,373,12861,364,484,5,280,1581,15948
2019-05-10,375,12864,364,484,5,306,1584,15982
2019-05-09,374,12837,363,480,5,304,1597,15960
2019-05-08,375,12869,363,477,5,314,1588,15991
2019-05-07,376,12883,363,474,5,324,1544,15969
2019-05-06,376,12887,363,477,5,321,1556,15985
2019-05-03,370,12890,362,480,5,386,1556,16049
2019-05-02,370,12867,359,448,5,339,1559,15947
2019-04-30,370,12839,362,447,5,348,1528,15899
2019-04-29,368,12816,367,441,5,341,1570,15908
2019-04-26,367,12825,368,439,5,349,1573,15926
2019-04-25,366,12809,368,434,5,340,1573,15895
2019-04-24,364,12786,367,449,5,343,1573,15887
2019-04-23,365,12817,364,457,5,333,1579,15920
2019-04-22,366,12814,361,453,5,305,1576,15880
2019-04-17,364,12817,361,461,5,289,1577,15874
2019-04-16,368,12814,361,457,5,279,1578,15862
2019-04-15,368,12800,361,461,5,261,1579,15835
2019-04-12,369,12798,362,454,5,253,1582,15823
2019-04-11,369,12770,362,435,5,263,1582,15786
2019-04-10,369,12773,362,425,5,273,1561,15768
2019-04-09,371,12731,362,421,5,289,1566,15745
2019-04-08,367,12715,363,420,5,290,1573,15733
2019-04-05,371,12703,363,421,5,301,1571,15735
2019-04-04,373,12754,365,424,5,292,1570,15783
2019-04-03,373,12758,365,428,5,304,1572,15805
2019-04-01,373,12763,363,427,5,303,1572,15806
2019-03-29,373,12751,363,443,5,319,1537,15791
2019-03-28,371,12763,363,423,5,326,1575,15826
2019-03-27,372,12753,360,420,5,335,1576,15821
2019-03-26,363,12750,363,431,5,325,1586,15823
2019-03-25,363,12788,364,422,5,311,1590,15843
2019-03-22,362,12786,364,418,7,315,1582,15834
2019-03-21,362,12785,366,426,7,306,1581,15833
2019-03-20,360,12771,365,423,7,311,1581,15818
2019-03-19,359,12766,365,428,7,305,1577,15807
2019-03-18,361,12763,365,446,7,290,1580,15812
2019-03-15,361,12807,366,444,7,287,1584,15856
2019-03-14,362,12751,366,437,7,305,1585,15813
2019-03-13,363,12669,366,432,7,315,1579,15731
2019-03-12,363,12674,366,434,7,327,1566,15737
2019-03-11,368,12673,368,432,7,333,1573,15754
2019-03-08,364,12663,368,429,7,359,1577,15767
2019-03-07,364,12642,369,429,7,371,1579,15761
2019-03-06,364,12623,369,435,7,363,1567,15728
2019-03-01,362,12639,369,443,7,377,1568,15765
2019-02-28,362,12634,368,433,7,357,1517,15678
2019-02-27,362,12616,369,446,7,397,1569,15766
2019-02-26,362,12633,368,444,7,390,1573,15777
2019-02-25,365,12621,368,422,7,380,1578,15741
2019-02-22,365,12624,368,421,7,377,1584,15746
2019-02-21,364,12625,368,418,7,366,1664,15812
2019-02-20,364,12608,368,414,7,373,1680,15814
2019-02-19,364,12597,368,419,7,365,1683,15803
2019-02-18,399,12538,368,423,7,340,1688,15763
2019-02-15,399,12532,368,426,7,335,1681,15748
2019-02-14,401,12559,368,426,7,342,1679,15782
2019-02-13,401,12521,368,428,7,339,1718,15782
2019-02-12,397,12508,369,430,7,361,1725,15797
2019-02-11,398,12485,369,416,7,369,1725,15769
2019-02-08,399,12509,368,423,7,397,1650,15753
2019-02-07,398,12474,368,421,7,391,1641,15700
2019-02-06,400,12470,368,425,7,401,1643,15714
2019-02-05,399,12417,368,427,7,412,1643,15673
2019-02-04,399,12413,367,426,7,396,1643,15651
2019-02-01,399,12436,367,427,7,434,1651,15721
2019-01-31,399,12446,367,424,7,420,1617,15680
2019-01-30,400,12441,367,421,7,432,1642,15710
2019-01-29,400,12456,366,424,7,415,1645,15713
2019-01-28,400,12459,366,431,7,404,1644,15711
2019-01-25,398,12488,366,430,7,405,1648,15742
2019-01-24,399,12471,366,426,7,391,1651,15711
2019-01-23,399,12469,360,425,7,392,1657,15709
2019-01-22,398,12438,361,425,7,380,1659,15668
2019-01-21,398,12428,360,424,7,360,1663,15640
2019-01-18,401,12436,359,427,7,350,1660,15640
2019-01-17,399,12433,359,427,7,336,1669,15630
2019-01-16,400,12433,359,430,7,330,1667,15626
2019-01-15,403,12405,359,431,7,306,1666,15577
2019-01-14,404,12372,360,432,7,281,1668,15524
2019-01-11,403,12349,360,432,7,275,1673,15499
2019-01-10,403,12305,360,430,7,285,1672,15462
2019-01-09,402,12308,359,429,7,294,1663,15462
2019-01-08,403,12327,360,434,7,301,1624,15456
2019-01-07,402,12288,360,434,7,290,1624,15405
2019-01-04,403,12297,360,434,7,286,1628,15415
2019-01-03,403,12277,359,429,7,271,1638,15384
2019-01-02,401,12262,359,429,7,250,1629,15337
2018-12-28,401,12283,357,426,7,265,1571,15310
2018-12-27,400,12334,358,424,7,260,1640,15423
2018-12-26,400,12412,356,424,7,234,1633,15466
2018-12-21,400,12434,354,425,7,240,1647,15507
2018-12-20,400,12423,356,425,7,236,1646,15493
2018-12-19,399,12451,356,422,7,242,1650,15527
2018-12-18,399,12484,354,423,7,236,1650,15553
2018-12-17,399,12583,354,417,7,222,1650,15632
2018-12-14,399,12606,355,418,7,222,1606,15613
2018-12-13,399,12482,355,421,7,223,1624,15511
2018-12-12,400,12464,354,410,7,230,1603,15468
2018-12-11,401,12447,352,405,7,244,1613,15469
2018-12-10,401,12437,352,405,7,244,1615,15461
2018-12-07,400,12453,353,407,7,249,1616,15485
2018-12-06,402,12481,352,404,7,251,1624,15521
2018-12-05,402,12526,352,403,7,256,1627,15573
2018-12-04,401,12522,353,410,7,257,1629,15579
2018-12-03,401,12508,353,411,7,264,1632,15576
2018-11-29,401,12498,353,418,7,273,1604,15554
2018-11-28,398,12529,353,395,7,292,1610,15584
2018-11-27,398,12492,347,395,7,279,1599,15517
2018-11-26,398,12463,347,400,7,266,1597,15478
2018-11-23,398,12516,346,410,7,271,1599,15547
2018-11-22,399,12510,346,414,7,261,1605,15542
2018-11-21,399,12504,346,415,7,270,1600,15541
2018-11-20,398,12500,346,415,7,255,1626,15547
2018-11-16,399,12505,346,428,7,249,1640,15574
2018-11-15,401,12460,343,416,7,255,1644,15526
2018-11-14,403,12429,343,416,7,265,1629,15492
2018-11-13,404,12419,344,422,7,276,1627,15499
2018-11-12,403,12391,344,427,7,285,1626,15483
2018-11-09,403,12415,342,427,7,298,1622,15514
2018-11-08,402,12423,342,426,7,299,1621,15520
2018-11-07,404,12404,342,424,7,305,1610,15496
2018-11-05,404,12439,341,426,7,307,1611,15535
2018-11-02,407,12427,342,426,7,331,1614,15554
2018-11-01,406,12433,342,424,7,325,1615,15552
2018-10-31,403,12490,341,403,7,332,1578,15554
2018-10-30,403,12541,341,402,7,330,1618,15642
2018-10-29,406,12628,341,432,7,311,1612,15737
2018-10-26,407,12608,341,444,7,328,1614,15749
2018-10-25,406,12604,341,443,7,321,1603,15725
2018-10-24,389,12595,341,443,7,326,1599,15700
2018-10-23,393,12649,340,441,7,315,1613,15758
2018-10-22,433,12638,340,443,7,301,1626,15788
2018-10-19,424,12718,340,477,7,296,1617,15879
2018-10-18,424,12664,340,443,7,287,1623,15788
2018-10-17,424,12648,340,443,7,278,1616,15756
2018-10-16,426,12678,340,442,7,257,1619,15769
2018-10-12,427,12687,340,452,7,248,1625,15786
2018-10-11,423,12724,338,446,7,251,1624,15813
2018-10-10,425,12678,334,443,7,251,1625,15763
2018-10-09,420,12718,313,438,7,263,1626,15785
2018-10-08,420,12755,312,436,7,265,1632,15827
2018-10-05,422,12762,307,433,7,268,1633,15832
2018-10-04,421,12771,307,401,7,265,1633,15805
2018-10-03,421,12779,306,404,7,263,1629,15809
2018-10-02,418,12785,307,404,7,264,1630,15815
2018-10-01,421,12812,306,389,7,274,1635,15844
2018-09-28,423,12896,307,379,7,286,1634,15932
2018-09-27,390,12890,307,386,7,288,1638,15906
2018-09-26,421,12879,308,340,7,302,1639,15896
2018-09-25,421,12895,307,341,7,299,1638,15908
2018-09-24,419,12946,307,135,7,289,1649,15752
2018-09-21,417,13014,307,346,7,308,1655,16054
2018-09-20,420,13028,302,342,7,301,1654,16054
2018-09-19,420,13029,302,336,7,312,1655,16061
2018-09-18,421,13040,302,335,7,306,1653,16064
2018-09-17,421,13088,301,335,7,294,1652,16098
2018-09-14,421,13154,301,335,7,291,1660,16169
2018-09-13,419,13134,301,340,7,301,1664,16166
2018-09-12,413,13177,301,344,7,309,1644,16195
2018-09-11,414,13177,301,343,7,337,1651,16230
2018-09-10,414,13219,301,346,7,349,1649,16285
2018-09-07,414,13249,301,352,7,364,1646,16333
2018-09-06,415,13260,301,348,7,366,1638,16335
2018-09-05,412,13301,300,342,7,370,1648,16380
2018-09-04,412,13335,300,340,7,382,1642,16418
2018-09-03,412,13361,300,346,7,403,1645,16474
2018-08-31,412,13373,299,370,7,432,1642,16535
2018-08-30,372,13447,298,316,7,440,1662,16542
2018-08-29,369,13420,298,360,7,455,1647,16556
2018-08-28,369,13392,298,364,7,437,1657,16524
2018-08-27,368,13365,298,367,7,429,1659,16493
2018-08-24,368,13404,297,369,7,447,1682,16574
2018-08-23,358,13374,290,366,7,437,1683,16515
2018-08-22,358,13311,295,366,7,446,1692,16475
2018-08-21,358,13324,295,368,7,424,1686,16462
2018-08-17,358,13308,297,369,7,417,1710,16466
2018-08-16,352,13257,296,370,7,409,1680,16371
2018-08-15,348,13254,293,368,7,400,1668,16338
2018-08-14,341,13226,294,382,7,387,1671,16308
2018-08-13,340,13257,293,377,7,385,1671,16330
2018-08-10,340,13251,293,383,7,376,1671,16321
2018-08-09,341,13242,294,384,7,387,1666,16321
2018-08-08,340,13228,294,384,7,384,1665,16302
2018-08-07,341,13173,294,386,7,395,1656,16252
2018-08-06,341,13168,294,388,7,405,1659,16262
2018-08-03,339,13186,294,385,7,402,1660,16273
2018-08-02,341,13151,291,396,7,393,1660,16239
2018-08-01,340,13152,289,397,7,384,1653,16222
2018-07-31,341,13177,289,377,7,408,1650,16249
2018-07-30,340,13171,290,398,7,391,1647,16244
2018-07-27,340,13163,290,397,7,416,1646,16259
2018-07-26,339,13178,290,384,7,391,1651,16240
2018-07-25,341,13213,290,385,7,399,1646,16281
2018-07-24,341,13254,290,384,0,375,1641,16285
2018-07-23,342,13285,290,383,0,365,1648,16313
2018-07-20,341,13293,290,382,0,376,1657,16339
2018-07-19,342,13120,291,382,0,366,1658,16159
2018-07-18,344,13002,292,382,0,376,1654,16050
2018-07-17,343,13082,291,386,0,356,1653,16111
2018-07-16,339,13100,291,388,0,337,1659,16114
2018-07-13,339,13121,290,388,0,331,1660,16129
2018-07-12,342,13128,290,370,0,343,1664,16137
2018-07-11,339,13155,290,367,0,365,1664,16180
2018-07-10,338,13149,289,366,0,366,1671,16179
2018-07-06,339,13221,288,362,0,370,1665,16245
2018-07-05,336,13188,287,360,0,366,1668,16205
2018-07-04,339,13183,287,330,0,368,1663,16170
2018-07-03,330,13183,287,361,0,373,1655,16189
2018-07-02,331,13173,287,127,0,376,1669,15963
2018-06-29,331,13199,286,127,0,400,1674,16017
2018-06-28,330,13264,280,126,0,412,1676,16088
2018-06-27,329,13247,277,126,0,427,1683,16089
2018-06-26,323,13286,277,341,0,416,1664,16307
2018-06-25,327,13316,276,342,0,424,1665,16350
2018-06-22,330,13280,276,127,0,428,1688,16129
2018-06-21,332,13306,275,324,0,421,1692,16350
2018-06-19,332,13349,275,323,0,431,1700,16410
2018-06-18,331,13337,275,322,0,418,1706,16389
2018-06-15,334,13293,275,322,0,411,1694,16329
2018-06-14,335,13269,276,328,0,424,1688,16320
2018-06-13,334,13241,276,338,0,431,1688,16308
2018-06-12,332,13272,277,340,0,467,1688,16376
2018-06-11,332,13261,277,344,0,475,1707,16396
2018-06-08,332,13226,277,125,0,492,1709,16161
2018-06-07,325,13272,278,353,0,493,1709,16430
2018-06-06,330,13274,277,353,0,529,1679,16442
2018-06-05,335,13280,277,351,0,542,1680,16465
2018-06-04,335,13315,277,351,0,548,1696,16522
2018-06-01,345,13339,277,342,0,590,1694,16587
2018-05-31,342,13341,277,342,0,560,1696,16558
2018-05-30,342,13326,277,341,0,603,1700,16589
2018-05-29,342,13307,278,313,0,581,1699,16520
2018-05-28,341,13331,278,314,0,566,1688,16518
2018-05-24,339,13354,278,316,0,594,1689,16570
2018-05-23,339,13361,278,316,0,607,1673,16574
2018-05-22,338,13355,275,316,0,601,1680,16565
2018-05-21,339,13401,275,317,0,580,1685,16597
2018-05-18,339,13435,274,306,0,571,1685,16610
2018-05-17,336,13439,274,308,0,555,1685,16597
2018-05-16,330,13470,274,310,0,538,1690,16612
2018-05-15,330,13510,271,303,0,518,1653,16585
2018-05-14,328,13500,268,299,0,498,1650,16543
2018-05-11,328,13475,268,310,0,498,1636,16515
2018-05-10,328,13442,267,315,0,520,1636,16508
2018-05-09,330,13422,267,315,0,535,1635,16504
2018-05-08,329,13395,267,313,0,570,1611,16485
2018-05-07,328,13398,267,322,0,568,1631,16514
2018-05-04,329,13412,267,323,0,567,1628,16526
2018-05-03,327,13399,267,322,0,571,1632,16518
2018-05-02,327,13368,266,330,0,555,1631,16477
2018-04-27,327,13404,266,331,0,569,1653,16550
2018-04-26,325,13351,265,330,0,579,1641,16491
2018-04-25,326,13324,264,331,0,593,1638,16476
2018-04-24,325,13285,264,332,0,577,1638,16421
2018-04-23,326,13287,264,315,0,552,1641,16385
2018-04-20,327,13289,264,316,0,577,1648,16421
2018-04-19,326,13254,263,316,0,559,1644,16362
2018-04-18,326,13186,263,316,0,571,1642,16304
2018-04-17,323,13188,263,317,0,556,1645,16292
2018-04-16,326,13186,263,317,0,533,1653,16278
2018-04-13,326,13193,263,317,0,523,1662,16284
2018-04-12,323,13097,258,318,0,522,1664,16182
2018-04-11,323,13043,257,115,0,544,1660,15942
2018-04-10,328,12962,255,317,0,562,1658,16082
2018-04-09,322,12952,254,317,0,572,1657,16074
2018-04-06,323,12942,255,317,0,588,1656,16081
2018-04-05,324,12892,251,317,0,574,1658,16016
2018-04-04,324,12804,251,317,0,535,1658,15889
2018-04-03,343,12749,251,317,0,548,1658,15866
2018-03-28,343,12691,251,317,0,532,1678,15812
2018-03-27,344,12790,250,314,0,573,1676,15947
2018-03-26,347,12825,252,310,0,558,1673,15965
2018-03-23,347,12825,252,310,0,586,1670,15990
2018-03-22,349,12893,247,309,0,573,1669,16040
2018-03-21,354,12896,243,309,0,590,1669,16061
2018-03-20,356,12892,241,309,0,575,1664,16037
2018-03-19,356,12893,241,309,0,551,1668,16018
2018-03-16,357,12960,242,309,0,544,1661,16073
2018-03-15,369,12941,242,309,0,563,1651,16075
2018-03-14,355,12959,241,308,0,570,1654,16087
2018-03-13,355,12936,238,309,0,613,1653,16104
2018-03-12,352,12914,238,302,0,619,1645,16070
2018-03-09,353,12924,240,301,0,629,1641,16088
2018-03-08,353,12889,239,300,0,625,1643,16049
2018-03-07,353,12899,239,300,0,632,1643,16066
2018-03-06,353,12886,237,301,0,654,1642,16073
2018-03-05,343,12886,237,300,0,661,1646,16073
2018-03-02,343,12871,237,298,0,708,1646,16103
2018-03-01,343,12866,237,298,0,702,1644,16090
2018-02-28,343,12837,237,300,0,720,1664,16101
2018-02-27,345,12719,237,295,0,748,1680,16024
2018-02-26,346,12718,238,295,0,694,1680,15971
2018-02-23,346,12674,237,295,0,741,1680,15973
2018-02-22,347,12677,237,295,0,732,1672,15960
2018-02-21,346,12679,230,295,0,744,1680,15974
2018-02-20,346,12634,230,295,0,718,1710,15933
2018-02-19,346,12650,230,297,0,682,1687,15892
2018-02-16,311,12652,230,297,0,678,1687,15855
2018-02-15,312,12598,229,288,0,704,1684,15815
2018-02-14,311,12610,229,286,0,752,1685,15873
2018-02-09,312,12617,229,285,0,772,1688,15903
2018-02-08,312,12591,227,289,0,764,1685,15868
2018-02-07,310,12541,228,289,0,770,1676,15814
2018-02-06,309,12494,224,288,0,793,1678,15786
2018-02-05,309,12460,222,290,0,786,1695,15762
2018-02-02,310,12436,222,290,0,838,1693,15789
2018-02-01,310,12403,222,290,0,821,1695,15741
2018-01-31,310,12385,222,289,0,824,1802,15832
2018-01-30,310,12378,222,278,0,801,1754,15743
2018-01-29,310,12388,222,278,0,799,1754,15751
2018-01-26,311,12296,215,278,0,789,1750,15639
2018-01-25,308,12302,215,278,0,765,1751,15619
2018-01-24,308,12303,215,278,0,770,1751,15625
2018-01-23,309,12291,215,279,0,742,1753,15589
2018-01-22,312,12257,215,281,0,711,1754,15530
2018-01-19,312,12228,215,281,0,683,1748,15467
2018-01-18,310,12211,213,281,0,662,1742,15419
2018-01-17,312,12195,213,281,0,637,1740,15378
2018-01-16,311,12148,213,278,0,605,1746,15301
2018-01-15,311,12142,212,278,0,560,1746,15249
2018-01-12,311,12145,212,279,0,540,1755,15242
2018-01-11,312,12082,212,279,0,544,1753,15182
2018-01-10,311,12042,212,278,0,557,1748,15148
2018-01-09,311,12069,212,266,0,562,1732,15152
2018-01-08,311,12119,212,266,0,522,1728,15158
2018-01-05,310,12132,211,268,0,517,1730,15168
2018-01-04,313,12023,211,269,0,525,1731,15072
2018-01-03,314,11972,211,271,0,518,1728,15014
2018-01-02,314,11947,211,269,0,491,1701,14933
2017-12-29,314,11954,211,268,0,519,1537,14803
2017-12-28,337,11920,211,264,0,510,1533,14775
2017-12-27,338,11904,205,267,0,523,1528,14765
2017-12-26,335,11952,205,259,0,506,1520,14777
2017-12-22,334,11950,203,262,0,539,1523,14811
2017-12-21,357,11912,198,262,0,527,1521,14777
2017-12-20,351,11866,197,262,0,542,1519,14737
2017-12-19,350,11901,197,264,0,529,1549,14790
2017-12-18,350,11899,196,263,0,507,1564,14779
2017-12-15,346,11899,196,263,0,501,1563,14768
2017-12-14,346,11863,200,265,0,538,1567,14779
2017-12-13,343,11889,199,265,0,555,1564,14815
2017-12-12,343,11860,199,266,0,587,1563,14818
2017-12-11,340,11853,200,266,0,556,1551,14766
2017-12-07,339,11805,198,265,0,575,1568,14750
2017-12-06,350,11781,198,265,0,579,1571,14744
2017-12-05,349,11743,197,264,0,595,1565,14713
2017-12-04,350,11776,194,264,0,605,1565,14754
2017-12-01,368,11777,194,261,0,643,1567,14810
2017-11-30,375,11776,194,259,0,617,1575,14796
2017-11-29,374,11548,193,259,0,642,1563,14579
2017-11-28,377,11698,193,260,0,624,1559,14711
2017-11-27,379,11725,194,260,0,607,1561,14726
2017-11-24,380,11702,193,242,0,633,1556,14706
2017-11-23,379,11657,192,241,0,610,1557,14636
2017-11-22,382,11680,193,240,0,624,1543,14662
2017-11-21,381,11716,193,240,0,594,1526,14650
2017-11-17,382,11686,193,240,0,577,1480,14558
2017-11-16,379,11720,193,240,0,565,1476,14573
2017-11-15,379,11717,193,239,0,549,1472,14549
2017-11-14,381,11696,193,239,0,529,1473,14511
2017-11-13,381,11677,193,238,0,502,1471,14462
2017-11-10,381,11685,193,239,0,489,1467,14454
2017-11-09,382,11605,194,238,0,501,1470,14390
2017-11-08,381,11640,194,237,0,508,1469,14429
2017-11-07,392,11609,193,227,0,523,1471,14415
2017-11-03,391,11625,193,227,0,547,1472,14455
2017-11-02,391,11613,193,227,0,544,1473,14441
2017-11-01,391,11607,194,226,0,553,1479,14450
2017-10-31,391,11597,194,226,0,583,1479,14470
2017-10-30,392,11582,192,226,0,565,1479,14436
2017-10-27,373,11597,192,224,0,586,1480,14452
2017-10-26,374,11616,192,224,0,572,1476,14454
2017-10-25,380,11567,193,224,0,585,1465,14414
2017-10-24,391,11559,193,221,0,565,1462,14391
2017-10-23,387,11524,193,222,0,543,1468,14337
2017-10-20,381,11545,192,221,0,563,1490,14392
2017-10-19,382,11566,192,221,0,546,1496,14403
2017-10-18,382,11538,192,221,0,551,1492,14376
2017-10-17,386,11560,191,219,0,518,1481,14355
2017-10-13,386,11604,191,219,0,503,1487,14390
2017-10-12,386,11569,191,218,0,515,1493,14372
2017-10-11,386,11562,191,218,0,509,1491,14357
2017-10-10,386,11555,191,217,0,536,1494,14379
2017-10-09,388,11555,189,213,0,538,1482,14365
2017-10-06,389,11558,189,213,0,551,1466,14366
2017-10-05,388,11564,189,214,0,541,1471,14367
2017-10-04,386,11538,189,213,0,538,1468,14332
2017-10-03,387,11535,189,212,0,551,1464,14338
2017-10-02,387,11522,189,213,0,545,1463,14319
2017-09-29,388,11474,189,209,0,571,1464,14295
2017-09-28,391,11425,188,206,0,570,1464,14244
2017-09-27,389,11384,183,206,0,581,1477,14220
2017-09-26,391,11360,183,206,0,561,1457,14158
2017-09-25,390,11340,183,207,0,540,1457,14117
2017-09-22,391,11353,181,207,0,573,1459,14164
2017-09-21,392,11286,180,207,0,555,1459,14079
2017-09-20,392,11297,180,208,0,546,1456,14079
2017-09-19,391,11307,180,206,0,534,1455,14073
2017-09-18,391,11298,179,207,0,514,1454,14043
2017-09-15,395,11285,180,208,0,523,1454,14045
2017-09-14,396,11278,179,90,0,532,1452,13927
2017-09-13,398,11270,179,206,0,504,1448,14005
2017-09-12,400,11261,180,207,0,573,1447,14068
2017-09-11,400,11250,180,206,0,576,1445,14057
2017-09-08,401,11262,180,205,0,560,1456,14064
2017-09-07,401,11282,179,204,0,572,1460,14098
2017-09-06,401,11266,179,203,0,573,1451,14073
2017-09-05,401,11281,179,203,0,596,1469,14129
2017-09-04,409,11301,177,203,0,612,1470,14172
2017-09-01,409,11282,177,203,0,660,1470,14201
2017-08-31,410,11291,177,202,0,634,1476,14190
2017-08-30,409,11301,177,200,0,671,1474,14232
2017-08-29,412,11298,174,201,0,650,1436,14171
2017-08-28,410,11227,174,205,0,631,1379,14026
2017-08-25,409,11192,173,88,0,691,1369,13922
2017-08-24,412,11193,164,205,0,665,1368,14007
2017-08-23,411,11174,164,204,0,663,1371,13987
2017-08-22,414,11145,164,203,0,623,1377,13926
2017-08-18,414,11186,164,202,0,598,1395,13959
2017-08-17,415,11147,164,200,0,575,1395,13896
2017-08-16,415,11132,163,202,0,562,1379,13853
2017-08-15,416,11212,163,202,0,548,1335,13876
2017-08-14,416,11168,162,203,0,526,1329,13804
2017-08-11,416,11222,163,198,0,513,1329,13841
2017-08-10,406,11215,163,197,0,523,1311,13815
2017-08-09,405,11194,162,194,0,523,1302,13780
2017-08-08,406,11182,162,195,0,554,1303,13802
2017-08-07,405,11225,161,194,0,561,1308,13854
2017-08-04,405,11240,161,195,0,561,1310,13872
2017-08-03,405,11228,161,195,0,553,1302,13844
2017-08-02,406,11164,160,195,0,544,1307,13776
2017-08-01,405,11165,161,195,0,557,1307,13790
2017-07-31,405,11138,161,189,0,560,1304,13757
2017-07-28,404,11119,161,187,0,576,1308,13755
2017-07-27,404,11110,161,188,0,559,1309,13731
2017-07-26,404,11053,161,189,0,565,1311,13683
2017-07-25,404,11057,159,188,0,541,1306,13655
2017-07-24,405,11031,154,185,0,517,1295,13587
2017-07-21,405,11045,154,187,0,539,1287,13617
2017-07-20,395,10968,154,188,0,523,1285,13513
2017-07-19,381,10935,154,187,0,519,1280,13456
2017-07-18,380,10915,154,189,0,503,1279,13420
2017-07-17,381,10895,154,190,0,482,1277,13379
2017-07-14,382,10861,151,190,0,469,1277,13330
2017-07-13,381,10767,151,190,0,477,1273,13239
2017-07-12,382,10707,151,189,0,479,1266,13174
2017-07-11,380,10672,151,184,0,499,1259,13145
2017-07-10,378,10609,150,180,0,502,1256,13075
2017-07-07,378,10581,150,180,0,510,1255,13054
2017-07-06,378,10539,150,179,0,504,1254,13004
2017-07-05,374,10474,150,180,0,506,1221,12905
2017-07-04,373,10420,150,181,0,522,1221,12867
2017-07-03,373,10378,149,182,0,524,1223,12829
2017-06-30,373,10330,149,182,0,538,1223,12795
2017-06-29,373,10280,147,181,0,557,1196,12734
2017-06-28,372,10220,147,181,0,561,1199,12680
2017-06-27,368,10051,145,182,0,547,1169,12462
2017-06-26,367,10023,145,182,0,528,1170,12415
2017-06-23,366,10015,145,180,0,550,1177,12433
2017-06-22,377,10006,144,179,0,545,1173,12424
2017-06-21,378,9971,144,178,0,549,1170,12390
2017-06-19,377,9991,144,178,0,533,1183,12406
2017-06-16,377,9952,144,178,0,522,1171,12344
2017-06-15,377,9957,143,178,0,541,1176,12372
2017-06-14,376,9923,135,178,0,551,1166,12329
2017-06-13,373,9867,135,177,0,586,1166,12304
2017-06-12,373,9842,135,177,0,595,1158,12280
2017-06-09,373,9786,134,176,0,604,1164,12237
2017-06-08,374,9694,133,174,0,599,1167,12141
2017-06-07,371,9684,132,172,0,603,1165,12127
2017-06-06,368,9676,132,172,0,612,1169,12129
2017-06-05,368,9708,132,172,0,624,1167,12171
2017-06-02,366,9500,132,171,0,664,1164,11997
2017-06-01,364,9442,132,168,0,661,1161,11928
2017-05-31,362,9406,132,167,0,648,1151,11866
2017-05-30,362,9414,131,167,0,637,1155,11866
2017-05-29,364,9400,133,162,0,616,1155,11830
2017-05-26,364,9393,134,162,0,630,1151,11834
2017-05-24,364,9366,134,160,0,612,1147,11783
2017-05-23,367,9284,133,156,0,614,1152,11706
2017-05-22,365,9168,133,154,0,595,1150,11565
2017-05-19,366,9135,133,155,0,581,1154,11524
2017-05-18,366,9165,133,155,0,565,1152,11536
2017-05-17,365,9010,130,157,0,548,1149,11359
2017-05-16,365,8959,129,155,0,532,1148,11288
2017-05-15,365,8931,130,155,0,504,1149,11234
2017-05-12,320,8906,130,154,0,489,1150,11149
2017-05-11,322,8890,129,153,0,507,1148,11149
2017-05-10,323,8869,128,152,0,531,1151,11154
2017-05-09,323,8761,128,151,0,557,1139,11059
2017-05-08,323,8738,128,152,0,536,1159,11036
2017-05-05,323,8715,129,152,0,533,1156,11008
2017-05-04,321,8693,128,151,0,528,1120,10941
2017-05-03,316,8664,128,151,0,538,1110,10907
2017-05-02,316,8654,128,151,0,540,1109,10898
2017-04-28,321,8601,128,149,0,550,1129,10878
2017-04-27,321,8585,128,146,0,552,1127,10859
2017-04-26,322,8565,128,146,0,555,1122,10838
2017-04-25,312,8566,129,146,0,539,1127,10819
2017-04-24,309,8509,127,145,0,528,1122,10740
2017-04-21,308,8508,126,145,0,544,1121,10752
2017-04-20,313,8445,126,144,0,527,1122,10677
2017-04-19,314,8383,126,141,0,535,1116,10615
2017-04-18,314,8360,126,142,0,513,1117,10572
2017-04-17,313,8340,126,143,0,471,1119,10512
2017-04-12,302,8338,145,141,0,491,1101,10518
2017-04-11,303,8321,145,140,0,515,1105,10529
2017-04-10,303,8313,145,140,0,526,1098,10525
2017-04-07,306,8245,146,138,0,526,1106,10467
2017-04-06,306,8204,146,139,0,522,1102,10419
2017-04-05,306,8168,146,140,0,536,1103,10399
2017-04-04,309,8119,146,140,0,545,1119,10378
2017-04-03,309,8087,146,139,0,537,1122,10340
2017-03-31,309,8038,146,138,0,566,1122,10319
2017-03-30,309,8035,148,137,0,576,1121,10326
2017-03-29,307,7950,148,136,0,594,1111,10246
2017-03-28,309,7937,146,135,0,572,1128,10227
2017-03-27,306,7885,146,133,0,560,1115,10145
2017-03-23,305,7822,146,132,0,596,1121,10122
2017-03-22,305,7809,144,132,0,610,1128,10128
2017-03-21,305,7755,142,130,0,597,1124,10053
2017-03-20,304,7735,142,129,0,580,1123,10013
2017-03-17,304,7690,142,126,0,576,1120,9958
2017-03-16,303,7669,142,126,0,597,1122,9959
2017-03-15,303,7629,142,126,0,610,1122,9932
2017-03-14,303,7642,142,125,0,650,1102,9964
2017-03-13,302,7635,142,125,0,663,1101,9968
2017-03-10,302,7673,142,125,0,688,1094,10024
2017-03-09,303,7627,142,125,0,710,1094,10001
2017-03-08,284,7600,142,124,0,734,1093,9977
2017-03-07,284,7639,142,123,0,738,1094,10020
2017-03-06,283,7628,142,124,0,733,1085,9995
2017-03-03,282,7598,142,124,0,773,1089,10008
2017-03-02,280,7596,143,124,0,744,1087,9974
2017-03-01,280,7552,142,123,0,740,1075,9912
2017-02-24,287,7562,143,123,0,731,1082,9928
2017-02-23,288,7579,143,124,0,746,1087,9967
2017-02-22,288,7537,143,123,0,751,1093,9935
2017-02-21,265,7522,143,122,0,735,1104,9891
2017-02-20,264,7472,142,122,0,715,1047,9762
2017-02-17,264,7479,142,123,0,703,1054,9765
2017-02-16,265,7429,142,124,0,688,1058,9706
2017-02-15,265,7345,142,123,0,668,1069,9612
2017-02-14,265,7310,131,122,0,642,1072,9542
2017-02-13,265,7271,131,122,0,610,1079,9478
2017-02-10,265,7209,131,122,0,592,1077,9396
2017-02-09,265,7235,131,120,0,604,1075,9430
2017-02-08,264,7199,131,118,0,608,1078,9398
2017-02-07,264,7194,131,117,0,636,1078,9420
2017-02-06,264,7168,131,119,0,638,1107,9427
2017-02-03,264,7120,132,118,0,635,1106,9375
2017-02-02,264,7127,132,118,0,630,1170,9441
2017-02-01,264,7092,132,117,0,621,1177,9403
2017-01-31,264,7088,132,117,0,631,1171,9403
2017-01-30,266,7084,131,117,0,617,1186,9401
2017-01-27,266,7098,131,117,0,616,1196,9424
2017-01-26,264,7056,145,134,0,594,1262,9455
2017-01-25,263,7063,145,133,0,580,1264,9448
2017-01-24,263,7063,145,133,0,553,1253,9410
2017-01-23,266,7016,145,133,0,531,1237,9328
2017-01-20,266,7024,145,132,0,538,1233,9338
2017-01-19,267,7024,143,130,0,521,1221,9306
2017-01-18,267,7001,143,130,0,516,1206,9263
2017-01-17,267,6985,143,129,0,490,1213,9227
2017-01-16,267,6959,143,129,0,457,1205,9160
2017-01-13,266,6960,144,129,0,440,1206,9145
2017-01-12,265,6943,144,129,0,437,1214,9132
2017-01-11,264,6928,144,129,0,431,1208,9104
2017-01-10,264,6901,144,129,0,433,1181,9052
2017-01-09,267,6884,144,128,0,423,1187,9033
2017-01-06,265,6896,142,127,0,417,1184,9031
2017-01-05,265,6951,141,126,0,407,1177,9067
2017-01-04,269,6961,141,126,0,397,1174,9068
2017-01-03,265,6957,140,127,0,406,1168,9063
2017-01-02,265,6964,140,127,0,405,1159,9060
2016-12-30,274,6960,141,125,0,408,1161,9069
2016-12-29,275,6972,140,125,0,420,1164,9096
2016-12-28,268,7004,136,125,0,427,1178,9138
2016-12-27,269,7031,134,125,0,413,1180,9152
2016-12-26,269,7034,134,124,0,405,1177,9143
2016-12-23,269,7010,132,124,0,436,1178,9149
2016-12-22,268,7030,132,122,0,428,1202,9182
2016-12-21,268,7034,132,121,0,432,1222,9209
2016-12-20,268,7019,129,120,0,432,1220,9188
2016-12-19,267,7014,129,119,0,421,1210,9160
2016-12-16,278,6980,126,118,0,417,1207,9126
2016-12-15,279,6998,125,118,0,443,1218,9181
2016-12-14,269,6991,125,117,0,460,1218,9180
2016-12-13,270,7017,125,116,0,473,1218,9219
2016-12-12,270,6997,122,115,0,451,1217,9172
2016-12-07,269,6977,123,114,0,468,1185,9136
2016-12-06,268,6965,121,112,0,485,1123,9074
2016-12-05,268,6972,121,111,0,483,1127,9082
2016-12-02,268,6971,121,111,0,524,1132,9127
2016-12-01,267,6975,119,110,0,512,1136,9119
2016-11-30,224,6924,118,110,0,510,1149,9035
2016-11-29,224,6913,118,109,0,491,1145,9000
2016-11-25,224,6925,118,108,0,502,1146,9023
2016-11-24,224,6844,114,96,0,490,1151,8919
2016-11-23,224,6838,114,95,0,494,1152,8917
2016-11-22,224,6840,114,95,0,482,1153,8908
2016-11-21,216,6831,113,94,0,472,1153,8879
2016-11-18,215,6877,113,94,0,462,1162,8923
2016-11-17,216,6895,107,92,0,451,1163,8924
2016-11-16,215,6905,107,91,0,439,1164,8921
2016-11-15,215,6903,106,90,0,428,1161,8903
2016-11-14,216,6874,106,90,0,411,1151,8848
2016-11-11,216,6841,106,91,0,401,1166,8821
2016-11-10,215,6803,105,92,0,411,1162,8788
2016-11-09,215,6780,104,91,0,420,1157,8767
2016-11-08,215,6776,98,89,0,442,1208,8828
2016-11-07,215,6735,97,89,0,443,1222,8801
2016-11-04,215,6726,97,88,0,446,1227,8799
2016-11-03,215,6713,94,88,0,439,1226,8775
2016-11-02,214,6691,94,87,0,436,1221,8743
2016-11-01,211,6643,94,87,0,444,1219,8698
2016-10-31,209,6605,90,95,0,466,1244,8709
2016-10-28,207,6626,88,85,0,473,1237,8716
2016-10-27,207,6608,88,85,0,461,1250,8699
2016-10-26,207,6549,88,83,0,467,1224,8618
2016-10-25,211,6516,88,81,0,453,1228,8577
2016-10-24,209,6471,88,81,0,441,1244,8534
2016-10-21,209,6406,88,81,0,452,1256,8492
2016-10-20,205,6428,88,80,0,441,1242,8484
2016-10-19,204,6425,88,79,0,443,1226,8465
2016-10-18,204,6422,89,79,0,437,1230,8461
2016-10-17,204,6414,86,78,0,421,1220,8423
2016-10-14,204,6390,86,77,0,411,1224,8392
2016-10-13,196,6381,86,77,0,425,1257,8422
2016-10-12,195,6382,86,77,0,423,1255,8418
2016-10-11,195,6358,86,75,0,427,1241,8382
2016-10-07,195,6339,85,72,0,433,1246,8370
2016-10-06,184,6344,85,73,0,424,1226,8336
2016-10-05,187,6313,85,73,0,425,1222,8305
2016-10-04,188,6285,84,72,0,427,1115,8171
2016-10-03,188,6235,84,72,0,429,1138,8146
2016-09-30,168,6247,83,71,0,441,1051,8061
2016-09-29,167,6249,83,70,0,441,1133,8143
2016-09-28,167,6241,82,69,0,453,1137,8149
2016-09-27,167,6195,83,68,0,434,1135,8082
2016-09-26,167,6169,82,67,0,414,1133,8032
2016-09-23,166,6170,82,66,0,433,1131,8048
2016-09-22,165,6140,82,63,0,421,1123,7994
2016-09-21,165,6113,77,65,0,421,1123,7964
2016-09-20,165,6112,77,64,0,411,1117,7946
2016-09-19,165,6071,77,64,0,396,1113,7886
2016-09-16,158,6056,77,64,0,389,1106,7850
2016-09-15,158,6025,75,63,0,404,1110,7835
2016-09-14,155,6015,74,62,0,409,1105,7820
2016-09-13,155,5981,74,63,0,428,1111,7812
2016-09-12,155,5916,74,61,0,434,1107,7747
2016-09-09,154,5885,74,61,0,440,1101,7715
2016-09-08,147,5866,74,60,0,435,1087,7669
2016-09-07,138,5866,74,59,0,433,1070,7640
2016-09-06,136,5868,72,59,0,446,1066,7647
2016-09-05,136,5834,72,59,0,457,1068,7626
2016-09-02,135,5851,72,59,0,487,1069,7673
2016-09-01,135,5796,72,59,0,477,1067,7606
2016-08-31,135,5798,72,59,0,480,957,7501
2016-08-30,135,5782,72,58,0,477,1017,7541
2016-08-29,134,5749,72,58,0,461,1003,7477
2016-08-26,134,5827,70,58,0,481,999,7569
2016-08-25,135,5732,70,58,0,464,997,7456
2016-08-24,134,5690,69,57,0,473,1004,7427
2016-08-23,132,5680,69,57,0,457,1001,7396
2016-08-22,131,5651,65,57,0,451,994,7349
2016-08-19,120,5627,65,56,0,442,965,7275
2016-08-18,120,5597,65,57,0,430,982,7251
2016-08-17,122,5582,65,57,0,409,986,7221
2016-08-16,118,5542,65,58,0,386,984,7153
2016-08-12,118,5523,65,58,0,373,975,7112
2016-08-11,119,5493,65,57,0,385,969,7088
2016-08-10,120,5464,65,57,0,392,952,7050
2016-08-09,113,5412,65,56,0,407,955,7008
2016-08-08,112,5406,65,56,0,410,962,7011
2016-08-05,109,5399,60,55,0,412,960,6995
2016-08-04,109,5365,61,57,0,406,964,6962
2016-08-03,109,5338,61,57,0,401,963,6929
2016-08-02,109,5300,61,57,0,417,965,6909
2016-08-01,108,5295,61,56,0,416,956,6892
2016-07-29,108,5277,61,55,0,420,885,6806
2016-07-28,108,5257,61,55,0,420,954,6855
2016-07-27,107,5304,60,54,0,426,948,6899
2016-07-26,106,5304,60,54,0,407,939,6870
2016-07-25,106,5281,60,54,0,393,944,6838
2016-07-22,106,5266,60,54,0,412,931,6829
2016-07-21,106,5232,59,53,0,400,934,6784
2016-07-20,106,5180,59,53,0,399,929,6726
2016-07-19,106,5134,59,51,0,386,933,6669
2016-07-18,106,5079,59,50,0,372,911,6577
2016-07-15,105,5118,59,50,0,364,910,6606
2016-07-14,104,5056,60,51,0,380,905,6556
2016-07-13,103,5036,59,51,0,402,904,6555
2016-07-12,102,5004,59,48,0,420,903,6536
2016-07-11,101,4979,59,48,0,405,875,6467
2016-07-07,100,4955,59,46,0,412,874,6446
2016-07-06,100,4900,59,48,0,418,868,6393
2016-07-05,100,4845,59,47,0,438,866,6355
2016-07-04,99,4817,54,47,0,449,861,6327
2016-07-01,104,4802,54,47,0,480,873,6360
2016-06-30,110,4783,44,46,0,457,808,6248
2016-06-29,106,4827,41,46,0,479,860,6359
2016-06-28,106,4815,43,45,0,472,857,6338
2016-06-27,104,4765,43,44,0,456,864,6276
2016-06-24,129,4750,42,44,0,467,877,6309
2016-06-23,131,4744,43,46,0,457,876,6297
2016-06-22,131,4693,42,44,0,445,843,6198
2016-06-21,131,4628,42,45,0,431,838,6115
2016-06-16,131,4661,44,45,0,414,851,6146
2016-06-15,130,4591,42,45,0,402,856,6066
2016-06-14,130,4548,43,44,0,385,856,6006
2016-06-13,130,4492,46,44,0,365,858,5935
2016-06-10,130,4469,46,43,0,355,859,5902
2016-06-09,130,4447,46,43,0,360,851,5877
2016-06-08,130,4426,46,40,0,368,854,5864
2016-06-07,131,4397,46,38,0,383,860,5855
2016-06-06,130,4380,46,40,0,384,859,5839
2016-06-03,130,4393,46,38,0,379,871,5857
2016-06-02,129,4345,46,38,0,376,868,5802
2016-06-01,129,4327,45,38,0,385,857,5781
2016-05-31,129,4304,46,37,0,397,798,5711
2016-05-30,128,4186,45,38,0,379,854,5630
2016-05-27,128,4181,45,37,0,384,857,5632
2016-05-26,126,4134,45,37,0,364,876,5582
2016-05-24,124,4137,45,35,0,359,890,5590
2016-05-23,123,4096,45,35,0,347,870,5516
2016-05-20,123,4098,45,34,0,361,859,5520
2016-05-19,122,4050,45,33,0,349,845,5444
2016-05-18,121,3995,45,33,0,354,845,5393
2016-05-17,121,3961,45,33,0,332,827,5319
2016-05-16,121,3926,45,31,0,331,822,5276
2016-05-13,121,3889,46,31,0,321,814,5222
2016-05-12,120,3852,46,30,0,327,783,5158
2016-05-11,120,3825,46,29,0,329,770,5119
2016-05-10,118,3782,47,29,0,340,767,5083
2016-05-09,119,3763,47,28,0,341,760,5058
2016-05-06,117,3758,47,27,0,346,752,5047
2016-05-05,118,3716,47,29,0,340,752,5002
2016-05-04,116,3656,47,29,0,339,728,4915
2016-05-03,116,3654,46,28,0,353,721,4918
2016-05-02,115,3570,46,29,0,360,716,4836
2016-04-29,116,3545,46,28,0,365,690,4790
2016-04-28,116,3585,46,27,0,371,673,4818
2016-04-27,116,3534,46,25,0,379,668,4768
2016-04-26,112,3483,46,24,0,364,668,4697
2016-04-25,111,3444,46,24,0,354,667,4646
2016-04-22,111,3384,46,23,0,365,668,4597
2016-04-21,110,3360,46,22,0,356,668,4562
2016-04-20,110,3354,46,23,0,359,652,4544
2016-04-19,105,3333,46,23,0,352,682,4541
2016-04-18,104,3254,46,22,0,339,680,4445
2016-04-15,104,3197,46,22,0,331,677,4377
2016-04-14,105,3168,46,20,0,338,670,4347
2016-04-13,105,3136,46,20,0,341,667,4315
2016-04-12,106,3122,46,20,0,357,664,4315
2016-04-11,104,3070,53,18,0,357,655,4257
2016-04-08,67,3040,57,18,0,364,619,4165
2016-04-07,67,3012,57,17,0,357,598,4108
2016-04-06,64,2998,57,16,0,363,600,4098
2016-04-05,64,2994,58,16,0,358,594,4084
2016-04-04,61,2975,58,16,0,368,585,4063
2016-04-01,56,2967,58,16,0,395,585,4077
2016-03-31,50,2946,58,14,0,359,580,4007
2016-03-30,50,2931,60,14,0,398,578,4031
2016-03-29,50,2908,60,14,0,376,580,3988
2016-03-28,49,2907,60,15,0,345,576,3952
2016-03-23,46,2896,58,15,0,365,577,3957
2016-03-22,47,2872,58,14,0,379,579,3949
2016-03-21,48,2834,58,13,0,366,578,3897
2016-03-18,48,2813,58,12,0,363,582,3876
2016-03-17,48,2745,58,12,0,375,575,3813
2016-03-16,48,2733,58,12,0,384,572,3807
2016-03-15,48,2693,57,11,0,415,573,3797
2016-03-14,48,2691,57,10,0,426,568,3800
2016-03-11,48,2678,63,10,0,437,570,3806
2016-03-10,48,2671,63,10,0,435,568,3795
2016-03-09,49,2664,63,10,0,441,567,3794
2016-03-08,49,2656,63,9,0,466,561,3804
2016-03-07,49,2648,63,10,0,486,558,3814
2016-03-04,49,2622,63,10,0,520,558,3822
2016-03-03,49,2624,63,8,0,515,558,3817
2016-03-02,49,2606,63,9,0,527,545,3799
2016-03-01,49,2601,63,8,0,518,544,3783
2016-02-29,39,2593,63,8,0,492,541,3736
2016-02-26,40,2568,78,8,0,526,546,3766
2016-02-25,40,2532,78,8,0,514,545,3717
2016-02-24,40,2495,79,8,0,523,544,3689
2016-02-23,40,2473,79,8,0,507,546,3653
2016-02-22,40,2455,83,8,0,496,550,3632
2016-02-19,40,2436,83,8,0,487,556,3610
2016-02-18,42,2361,83,8,0,475,540,3509
2016-02-17,42,2362,83,8,0,469,537,3501
2016-02-16,42,2317,83,8,0,452,537,3439
2016-02-15,41,2315,83,8,0,428,541,3416
2016-02-12,41,2302,83,8,0,416,542,3392
2016-02-11,41,2271,84,8,0,428,544,3376
2016-02-10,41,2265,84,8,0,419,549,3366
2016-02-05,41,2251,84,8,0,437,551,3372
2016-02-04,42,2218,84,8,0,431,556,3339
2016-02-03,42,2199,84,8,0,422,555,3310
2016-02-02,42,2187,84,8,0,428,554,3303
2016-02-01,42,2178,84,8,0,424,553,3289
2016-01-29,43,2178,84,8,0,425,547,3285
2016-01-28,42,2176,94,8,0,429,549,3298
2016-01-27,42,2166,94,8,0,439,549,3298
2016-01-26,42,2121,94,8,0,416,548,3229
2016-01-25,42,2083,104,8,0,422,541,3200
2016-01-22,42,2072,104,8,0,419,540,3185
2016-01-21,41,2054,104,8,0,402,539,3148
2016-01-20,41,2045,104,8,0,404,538,3140
2016-01-19,42,2011,104,8,0,388,537,3090
2016-01-18,42,1966,104,8,0,372,544,3036
2016-01-15,41,1955,104,8,0,361,534,3003
2016-01-14,43,1953,105,8,0,366,527,3002
2016-01-13,44,1950,95,8,0,375,527,2999
2016-01-12,44,1939,95,8,0,386,527,2999
2016-01-11,41,1929,95,7,0,385,552,3009
2016-01-08,40,1930,95,7,0,390,551,3013
2016-01-07,41,1890,95,7,0,389,552,2974
2016-01-06,43,1870,95,7,0,395,542,2952
2016-01-05,43,1824,94,7,0,399,538,2905
2016-01-04,43,1837,94,8,0,400,538,2920
2015-12-31,43,1859,94,7,0,399,566,2968
2015-12-30,43,1842,94,7,0,437,567,2990
2015-12-29,18,1838,94,7,0,424,551,2932
2015-12-28,18,1820,95,5,0,424,546,2908
2015-12-24,18,1802,95,6,0,443,550,2914
2015-12-23,18,1805,95,6,0,440,551,2915
2015-12-22,19,1797,95,6,0,433,494,2844
2015-12-21,19,1783,95,6,0,421,493,2817
2015-12-18,19,1786,94,6,0,424,500,2829
2015-12-17,20,1769,95,6,0,415,485,2790
2015-12-16,20,1774,95,8,0,402,474,2773
2015-12-15,20,1785,96,8,0,430,473,2812
2015-12-14,19,1825,97,8,0,417,478,2844
2015-12-11,19,1841,98,8,0,413,477,2856
2015-12-10,20,1851,98,8,0,429,478,2884
2015-12-09,19,1864,100,8,0,430,476,2897
2015-12-04,20,1916,101,8,0,455,466,2966
2015-12-03,19,1949,101,8,0,452,468,2997
2015-12-02,20,1985,101,8,0,462,470,3046
2015-12-01,21,1974,102,8,0,478,469,3052
2015-11-30,20,2002,102,8,0,464,469,3065
2015-11-26,21,2066,102,8,0,473,476,3146
2015-11-25,21,2097,102,8,0,493,475,3196
2015-11-24,28,2117,102,8,0,481,474,3210
2015-11-23,28,2142,103,8,0,465,472,3218
2015-11-20,28,2168,104,8,0,482,479,3269
2015-11-19,29,2211,106,8,0,471,491,3316
2015-11-18,30,2244,110,8,0,477,491,3360
2015-11-17,30,2267,112,8,0,460,488,3365
2015-11-16,30,2276,112,8,0,448,492,3366
2015-11-13,32,2288,113,8,0,437,502,3380
2015-11-12,33,2308,114,8,0,446,501,3410
2015-11-11,33,2316,114,8,0,441,507,3419
2015-11-10,36,2320,114,8,0,459,509,3446
2015-11-09,35,2343,115,8,0,464,504,3469
2015-11-05,35,2344,115,8,0,466,509,3477
2015-11-04,35,2339,116,8,0,474,511,3483
2015-11-03,36,2353,116,8,0,481,510,3504
2015-11-02,38,2368,116,8,0,481,492,3503
2015-10-30,40,2376,116,8,0,478,498,3516
2015-10-29,40,2387,116,8,0,499,497,3547
2015-10-28,40,2412,116,8,0,517,489,3582
2015-10-27,40,2411,116,8,0,504,494,3573
2015-10-26,40,2422,116,8,0,488,493,3567
2015-10-23,39,2450,116,8,0,509,496,3618
2015-10-22,39,2477,116,8,0,496,512,3648
2015-10-21,39,2499,116,8,0,503,513,3678
2015-10-20,39,2510,116,8,0,495,512,3680
2015-10-19,39,2517,116,8,0,480,508,3668
2015-10-16,38,2538,121,8,0,468,509,3682
2015-10-15,38,2494,121,8,0,481,519,3661
2015-10-14,38,2495,121,8,0,495,556,3713
2015-10-13,40,2510,110,8,0,498,554,3720
2015-10-09,40,2526,110,8,0,503,563,3750
2015-10-08,39,2542,110,8,0,497,567,3763
2015-10-07,39,2547,110,8,0,492,564,3760
2015-10-06,40,2554,110,8,0,512,563,3787
2015-10-05,40,2563,110,8,0,523,564,3808
2015-10-02,41,2563,110,8,0,541,582,3845
2015-10-01,40,2578,110,8,0,533,583,3852
2015-09-30,40,2587,110,8,0,532,592,3869
2015-09-29,40,2595,110,8,0,524,598,3875
2015-09-28,40,2606,110,8,0,500,631,3895
2015-09-25,39,2612,111,8,0,510,663,3943
2015-09-24,39,2638,111,8,0,497,671,3964
2015-09-23,38,2653,111,8,0,499,676,3985
2015-09-22,41,2675,111,8,0,483,676,3994
2015-09-21,40,2672,111,8,0,463,677,3971
2015-09-18,39,2679,111,8,0,455,694,3986
2015-09-17,38,2718,111,8,0,441,700,4016
2015-09-16,38,2714,111,8,0,425,705,4001
2015-09-15,38,2715,111,8,0,413,709,3994
2015-09-14,38,2733,111,8,0,388,709,3987
2015-09-11,45,2743,111,8,0,374,717,3998
2015-09-10,45,2747,111,8,0,377,716,4004
2015-09-09,45,2760,111,8,0,380,717,4021
2015-09-08,46,2782,112,8,0,394,714,4056
2015-09-07,47,2798,112,8,0,391,724,4080
2015-09-04,46,2807,112,8,0,393,723,4089
2015-09-03,46,2840,112,8,0,384,723,4113
2015-09-02,46,2852,112,8,0,381,707,4106
2015-09-01,47,2862,103,8,0,394,706,4120
2015-08-31,47,2870,99,8,0,399,725,4148
2015-08-28,47,2904,96,8,0,415,711,4181
2015-08-27,47,2925,96,8,0,404,708,4188
2015-08-26,48,2941,92,8,0,407,695,4191
2015-08-25,51,2936,96,8,0,394,696,4181
2015-08-24,53,2958,96,8,0,379,696,4190
2015-08-21,52,2989,96,8,0,388,699,4232
2015-08-20,52,3009,97,8,0,377,698,4241
2015-08-19,52,3021,97,8,0,378,700,4256
2015-08-18,52,3034,97,8,0,355,681,4227
2015-08-14,51,3040,98,8,0,347,699,4243
2015-08-13,52,3027,99,8,0,353,701,4240
2015-08-12,52,3022,98,8,0,353,729,4262
2015-08-11,54,3043,98,9,0,367,725,4296
2015-08-10,54,3038,99,9,0,371,722,4293
2015-08-07,54,3070,99,9,0,376,738,4346
2015-08-06,56,3080,99,9,0,370,747,4361
2015-08-05,77,3090,99,9,0,364,754,4393
2015-08-04,77,3107,99,9,0,378,756,4426
2015-08-03,80,3108,99,9,0,376,758,4430
2015-07-31,80,3108,99,9,0,376,763,4435
2015-07-30,80,3111,99,9,0,392,764,4455
2015-07-29,81,3114,99,9,0,399,764,4466
2015-07-28,81,3121,99,8,0,382,767,4458
2015-07-27,83,3120,100,8,0,366,777,4454
2015-07-24,83,3118,100,8,0,377,770,4456
2015-07-23,87,3107,100,8,0,353,768,4423
2015-07-22,87,3104,100,8,0,365,760,4424
2015-07-21,88,3102,100,8,0,353,757,4408
2015-07-20,88,3108,100,8,0,340,763,4407
2015-07-17,88,3105,100,8,0,328,764,4393
2015-07-16,88,3081,100,8,0,344,764,4385
2015-07-15,88,3096,100,8,0,357,753,4402
2015-07-14,89,3074,101,8,0,371,751,4394
2015-07-13,89,3114,98,8,0,355,756,4420
2015-07-10,88,3118,98,8,0,358,755,4425
2015-07-08,88,3146,99,8,0,355,760,4456
2015-07-07,88,3119,99,8,0,377,761,4452
2015-07-06,89,3118,99,8,0,388,757,4459
2015-07-03,88,3110,99,8,0,413,762,4480
2015-07-02,89,3086,97,8,0,412,761,4453
2015-07-01,89,3079,97,9,0,417,760,4451
2015-06-30,90,3087,97,9,0,403,772,4458
2015-06-29,90,3106,97,8,0,399,760,4460
2015-06-26,92,3108,97,9,0,410,742,4458
2015-06-25,92,3104,98,8,0,400,752,4454
2015-06-24,92,3098,98,8,0,408,751,4455
2015-06-23,92,3106,98,8,0,402,750,4456
2015-06-22,95,3142,98,8,0,386,738,4467
2015-06-19,95,3170,98,8,0,378,729,4478
2015-06-18,94,3186,98,8,0,368,728,4482
2015-06-17,94,3171,98,8,0,358,731,4460
2015-06-16,94,3163,99,9,0,344,709,4418
2015-06-15,99,3168,100,9,0,330,710,4416
2015-06-12,100,3186,101,9,0,323,713,4432
2015-06-11,101,3167,102,9,0,327,709,4415
2015-06-10,101,3158,102,9,0,329,702,4401
2015-06-09,101,3152,102,9,0,348,694,4406
2015-06-08,103,3125,102,9,0,347,686,4372
2015-06-05,105,3108,102,9,0,347,676,4347
2015-06-04,105,3111,102,9,0,342,678,4347
2015-06-03,105,3105,102,9,0,349,678,4348
2015-06-02,106,3082,102,9,0,363,679,4341
2015-06-01,104,3074,102,9,0,353,667,4309
2015-05-29,101,3038,102,9,0,349,678,4277
2015-05-28,103,3045,102,9,0,364,667,4290
2015-05-27,103,3027,102,9,0,367,685,4293
2015-05-26,103,3031,102,8,0,344,685,4273
2015-05-22,103,3019,102,8,0,352,683,4267
2015-05-21,103,3008,102,8,0,344,712,4277
2015-05-20,104,2986,102,8,0,345,712,4257
2015-05-19,104,2992,103,8,0,337,701,4245
2015-05-18,104,2977,104,8,0,327,713,4233
2015-05-15,104,2950,104,8,0,322,706,4194
2015-05-14,103,2949,104,8,0,330,668,4162
2015-05-13,103,2946,104,8,0,340,664,4165
2015-05-12,105,2921,104,8,0,353,634,4125
2015-05-11,105,2924,104,8,0,354,635,4130
2015-05-08,105,2925,104,8,0,366,612,4120
2015-05-07,104,2895,104,8,0,365,613,4089
2015-05-06,102,2886,104,8,0,383,641,4124
2015-05-05,104,2876,104,8,0,393,640,4125
2015-05-04,104,2881,104,8,0,382,634,4113
2015-04-30,104,2884,104,7,0,383,658,4140
2015-04-29,102,2870,104,7,0,412,651,4146
2015-04-28,100,2821,106,7,0,403,654,4091
2015-04-27,100,2802,106,8,0,390,654,4060
2015-04-24,100,2776,106,7,0,400,638,4027
2015-04-23,103,2762,106,7,0,394,643,4015
2015-04-22,103,2770,106,7,0,401,627,4014
2015-04-21,103,2758,106,7,0,398,625,3997
2015-04-20,104,2744,106,7,0,389,622,3972
2015-04-17,102,2732,106,7,0,384,612,3943
2015-04-16,109,2724,106,7,0,376,612,3934
2015-04-15,119,2712,106,7,0,366,602,3912
2015-04-14,131,2687,106,7,0,355,598,3884
2015-04-13,131,2694,106,7,0,342,601,3881
2015-04-10,130,2673,106,7,0,337,590,3843
2015-04-09,130,2653,106,7,0,358,588,3842
2015-04-08,130,2631,106,7,0,373,556,3803
2015-04-07,131,2594,107,7,0,372,547,3758
2015-04-06,131,2549,107,7,0,358,546,3698
2015-04-01,131,2532,107,7,0,360,534,3671
2015-03-31,112,2519,109,7,0,374,525,3646
2015-03-30,112,2518,107,7,0,361,524,3629
2015-03-27,112,2480,103,7,0,362,525,3589
2015-03-26,113,2488,103,7,0,351,520,3582
2015-03-25,113,2496,104,7,0,337,525,3582
2015-03-20,112,2506,99,7,0,336,514,3574
2015-03-19,111,2501,99,7,0,326,523,3567
2015-03-18,111,2503,99,7,0,340,522,3582
2015-03-17,107,2484,100,7,0,338,522,3558
2015-03-16,106,2499,100,7,0,329,524,3565
2015-03-13,107,2497,100,7,0,325,524,3560
2015-03-12,110,2486,100,7,0,332,521,3556
2015-03-11,108,2487,99,7,0,334,526,3561
2015-03-10,110,2473,99,7,0,355,518,3562
2015-03-09,111,2471,99,7,0,362,518,3568
2015-03-06,111,2474,99,7,0,369,546,3606
2015-03-05,111,2463,99,7,0,364,545,3589
2015-03-04,113,2461,100,7,0,365,547,3593
2015-03-03,113,2436,96,7,0,385,539,3576
2015-03-02,113,2416,96,7,0,391,533,3556
2015-02-27,113,2429,104,7,0,389,554,3596
2015-02-26,113,2378,96,7,0,412,524,3530
2015-02-25,113,2381,96,8,0,418,525,3541
2015-02-24,113,2358,96,8,0,410,528,3513
2015-02-23,113,2356,96,8,0,397,525,3495
2015-02-20,112,2358,96,8,0,397,528,3499
2015-02-19,112,2362,96,8,0,395,513,3486
2015-02-18,112,2353,96,8,0,392,509,3470
2015-02-13,114,2360,97,8,0,385,506,3470
2015-02-12,115,2361,97,8,0,375,495,3451
2015-02-11,115,2358,96,8,0,376,508,3461
2015-02-10,116,2353,96,8,0,390,504,3467
2015-02-09,117,2353,96,8,0,389,505,3468
2015-02-06,117,2369,96,8,0,393,503,3486
2015-02-05,116,2370,97,8,0,385,505,3481
2015-02-04,115,2351,96,8,0,381,506,3457
2015-02-03,115,2349,96,8,0,393,505,3466
2015-02-02,116,2356,96,8,0,393,503,3472
2015-01-30,116,2367,103,8,0,384,496,3474
2015-01-29,116,2362,86,8,0,390,504,3466
2015-01-28,115,2351,87,8,0,386,504,3451
2015-01-27,115,2340,87,8,0,371,497,3418
2015-01-26,110,2369,87,8,0,353,496,3423
2015-01-23,110,2356,87,8,0,353,495,3409
2015-01-22,110,2366,87,8,0,344,497,3412
2015-01-21,109,2375,87,8,0,342,497,3418
2015-01-20,107,2369,87,8,0,334,497,3402
2015-01-19,106,2375,87,8,0,313,496,3385
2015-01-16,106,2377,87,8,0,304,496,3378
2015-01-15,96,2372,88,9,0,293,496,3354
2015-01-14,86,2364,88,9,0,294,493,3334
2015-01-13,92,2364,88,9,0,302,473,3328
2015-01-12,91,2356,89,9,0,314,460,3319
2015-01-09,91,2341,89,9,0,316,498,3344
2015-01-08,92,2344,88,9,0,315,505,3353
2015-01-07,92,2348,88,9,0,320,502,3359
2015-01-06,92,2349,89,9,0,322,501,3362
2015-01-05,93,2363,89,9,0,313,500,3367
2015-01-02,93,2354,89,9,0,315,498,3358
2014-12-30,105,2357,96,9,0,274,489,3330
2014-12-29,104,2374,89,9,0,301,497,3374
2014-12-24,105,2365,89,9,0,305,496,3369
2014-12-23,102,2369,89,9,0,305,494,3368
2014-12-22,102,2365,90,9,0,309,496,3371
2014-12-19,103,2345,90,9,0,306,493,3346
2014-12-18,99,2344,90,9,0,300,488,3330
2014-12-17,99,2327,90,9,0,292,483,3300
2014-12-16,101,2291,91,9,0,284,478,3254
2014-12-15,98,2289,91,9,0,274,480,3241
2014-12-12,98,2287,93,10,0,272,468,3228
2014-12-11,98,2288,94,10,0,267,476,3233
2014-12-10,98,2287,94,10,0,276,461,3226
2014-12-09,91,2294,94,10,0,289,476,3254
2014-12-05,92,2347,94,10,0,289,476,3308
2014-12-04,101,2406,94,10,0,285,492,3388
2014-12-03,104,2399,94,10,0,289,492,3388
2014-12-02,104,2409,94,10,0,298,495,3410
2014-12-01,104,2397,92,10,0,295,505,3403
2014-11-28,104,2415,115,10,0,270,498,3412
2014-11-27,104,2440,98,10,0,297,499,3448
2014-11-26,104,2449,98,10,0,302,502,3465
2014-11-25,104,2438,98,10,0,291,490,3431
2014-11-21,102,2469,98,10,0,297,510,3486
2014-11-20,102,2472,98,10,0,295,512,3489
2014-11-19,103,2483,99,10,0,301,510,3506
2014-11-18,101,2477,99,10,0,294,517,3498
2014-11-17,101,2493,99,10,0,287,517,3507
2014-11-14,99,2497,98,10,0,284,534,3522
2014-11-13,102,2502,98,10,0,281,533,3526
2014-11-12,102,2498,98,10,0,282,538,3528
2014-11-11,104,2511,98,10,0,300,536,3559
2014-11-10,103,2514,98,10,0,303,540,3568
2014-11-07,104,2530,98,10,0,316,545,3603
2014-11-05,104,2540,98,10,0,307,536,3595
2014-11-04,103,2549,98,10,0,324,537,3621
2014-11-03,103,2557,98,10,0,329,540,3637
2014-10-31,118,2577,115,10,0,306,522,3648
2014-10-30,117,2579,99,10,0,346,531,3682
2014-10-29,117,2571,99,10,0,351,532,3680
2014-10-28,114,2602,98,10,0,343,529,3696
2014-10-27,114,2609,98,10,0,333,527,3691
2014-10-24,114,2614,98,10,0,335,518,3689
2014-10-23,116,2626,99,10,0,338,518,3707
2014-10-22,113,2637,99,10,0,341,515,3715
2014-10-21,114,2644,99,11,0,333,523,3724
2014-10-20,111,2655,99,11,0,326,525,3727
2014-10-17,109,2703,99,11,0,322,516,3760
2014-10-16,109,2712,99,11,0,324,517,3772
2014-10-15,111,2717,100,11,0,331,519,3789
2014-10-14,112,2737,99,11,0,333,520,3812
2014-10-10,115,2745,100,11,0,339,528,3838
2014-10-09,113,2765,100,11,0,337,520,3846
2014-10-08,114,2787,100,11,0,334,518,3864
2014-10-07,114,2794,100,11,0,340,517,3876
2014-10-06,114,2813,100,11,0,345,527,3910
2014-10-03,101,2807,100,11,0,358,527,3904
2014-10-02,102,2848,100,11,1,350,532,3944
2014-10-01,103,2846,97,11,0,352,529,3938
2014-09-30,102,2891,117,11,0,335,513,3969
2014-09-29,83,2909,100,11,0,331,550,3984
2014-09-26,84,2916,100,11,0,331,549,3991
2014-09-25,86,2924,100,11,0,322,562,4005
2014-09-24,85,2928,100,11,0,323,565,4012
2014-09-23,78,2931,102,11,0,313,546,3981
2014-09-22,88,2920,103,11,0,300,534,3956
2014-09-19,97,2957,103,11,0,295,536,3999
2014-09-18,97,2961,103,11,0,285,541,3998
2014-09-17,99,2966,103,11,0,275,537,3991
2014-09-16,99,2965,103,11,0,265,538,3981
2014-09-15,101,2991,103,11,0,252,534,3992
2014-09-12,103,3015,101,11,0,243,530,4003
2014-09-11,101,3015,103,11,0,240,531,4001
2014-09-10,99,3030,103,11,0,237,527,4007
2014-09-09,90,3042,103,11,0,250,529,4025
2014-09-08,90,3070,103,11,0,247,528,4049
2014-09-05,89,3096,103,11,0,244,519,4062
2014-09-04,86,3098,103,11,0,250,519,4067
2014-09-03,84,3148,103,11,0,243,522,4111
2014-09-02,85,3141,104,11,0,249,522,4112
2014-09-01,107,3160,103,11,0,250,513,4144
2014-08-29,107,3177,120,11,0,234,498,4147
2014-08-28,107,3171,104,12,0,257,516,4167
2014-08-27,104,3176,104,12,0,261,516,4173
2014-08-26,104,3207,104,12,0,254,515,4196
2014-08-25,104,3216,104,12,0,246,513,4195
2014-08-22,104,3214,104,12,0,248,518,4200
2014-08-21,107,3225,105,12,0,245,511,4205
2014-08-20,107,3236,105,12,0,254,502,4216
2014-08-19,107,3242,105,12,0,243,505,4214
2014-08-15,106,3258,105,12,0,237,498,4216
2014-08-14,107,3286,105,12,0,237,495,4242
2014-08-13,106,3294,105,12,0,238,493,4248
2014-08-12,107,3277,105,12,0,255,474,4230
2014-08-11,107,3263,105,12,0,252,472,4211
2014-08-08,106,3265,105,12,0,259,479,4226
2014-08-07,106,3281,105,12,0,258,475,4237
2014-08-06,113,3264,105,12,0,256,475,4225
2014-08-05,106,3267,105,12,0,268,475,4233
2014-08-04,106,3268,104,12,0,267,478,4235
2014-08-01,106,3277,103,12,0,283,468,4249
2014-07-31,105,3304,105,12,0,258,480,4264
2014-07-30,106,3291,105,13,0,280,471,4266
2014-07-29,106,3268,106,13,0,271,466,4230
2014-07-28,106,3280,106,13,0,264,466,4235
2014-07-25,106,3291,106,13,0,263,472,4251
2014-07-24,106,3301,106,13,0,256,471,4253
2014-07-23,100,3292,106,13,0,257,473,4241
2014-07-22,100,3300,106,13,0,249,471,4239
2014-07-21,100,3292,106,13,0,242,480,4233
2014-07-18,100,3300,107,13,0,238,475,4233
2014-07-17,99,3300,107,13,0,233,469,4221
2014-07-16,99,3328,106,13,0,225,469,4240
2014-07-15,99,3348,107,13,0,220,469,4256
2014-07-14,99,3309,107,14,0,207,473,4209
2014-07-11,99,3283,107,14,0,202,471,4176
2014-07-10,102,3291,107,14,0,198,462,4174
2014-07-08,103,3261,107,14,0,217,455,4157
2014-07-07,101,3268,106,14,0,218,447,4154
2014-07-04,100,3277,107,14,0,224,435,4157
2014-07-03,100,3268,107,14,0,223,436,4148
2014-07-02,100,3223,105,14,0,226,452,4120
2014-07-01,100,3273,102,14,0,234,428,4151
2014-06-30,100,3252,115,14,0,222,432,4135
2014-06-27,100,3222,105,14,0,231,442,4114
2014-06-26,100,3234,106,14,0,227,456,4137
2014-06-25,100,3245,106,14,0,230,455,4150
2014-06-24,100,3246,106,14,0,222,454,4142
2014-06-23,99,3243,106,14,0,215,440,4117
2014-06-19,99,3267,106,14,0,212,467,4165
2014-06-18,99,3274,106,14,0,216,459,4168
2014-06-17,99,3315,107,14,0,214,440,4189
2014-06-16,99,3314,108,14,0,207,439,4181
2014-06-13,99,3291,110,14,0,204,439,4157
2014-06-12,99,3309,115,15,0,203,437,4178
2014-06-11,99,3331,115,15,0,202,435,4197
2014-06-10,100,3320,115,15,0,217,438,4205
2014-06-09,99,3283,115,15,0,217,437,4166
2014-06-06,100,3268,115,14,0,222,413,4132
2014-06-05,100,3254,115,14,0,219,418,4120
2014-06-04,100,3270,115,15,0,215,408,4123
2014-06-03,100,3256,117,15,0,227,410,4125
2014-06-02,100,3256,117,15,0,227,410,4125
2014-05-30,100,3264,117,15,0,219,404,4119
2014-05-29,100,3286,118,15,0,234,379,4132
2014-05-28,100,3280,118,15,0,236,369,4118
2014-05-27,100,3261,118,15,0,231,386,4111
2014-05-26,100,3263,119,15,0,222,385,4104
2014-05-23,100,3268,119,15,0,225,385,4112
2014-05-22,87,3268,119,15,0,221,379,4089
2014-05-21,87,3262,119,15,0,226,381,4090
2014-05-20,87,3248,119,15,0,220,374,4063
2014-05-19,87,3232,119,15,0,215,362,4030
2014-05-16,87,3233,119,15,0,214,364,4032
2014-05-15,87,3243,120,15,0,216,368,4049
2014-05-14,87,3267,120,15,0,219,366,4074
2014-05-13,86,3283,120,15,0,227,366,4097
2014-05-12,87,3246,120,15,0,238,369,4075
2014-05-09,86,3247,120,15,0,241,367,4076
2014-05-08,87,3226,120,15,0,248,369,4065
2014-05-07,87,3194,120,15,0,254,356,4026
2014-05-06,87,3166,124,15,0,265,335,3992
2014-05-05,85,3179,124,15,0,247,336,3986
2014-04-30,85,3189,124,16,0,229,340,3983
2014-04-29,85,3179,124,16,0,256,331,3991
2014-04-28,85,3161,124,16,0,249,327,3962
2014-04-25,85,3127,125,16,0,252,316,3921
2014-04-24,85,3109,125,16,0,247,347,3929
2014-04-23,83,3108,125,16,0,253,341,3926
2014-04-22,84,3103,125,16,0,246,340,3914
2014-04-21,83,3086,125,16,0,235,338,3883
2014-04-16,83,3074,125,16,0,224,344,3866
2014-04-15,83,3027,125,16,0,220,340,3811
2014-04-14,83,2967,125,16,0,211,345,3747
2014-04-11,83,2920,125,16,0,211,354,3709
2014-04-10,83,2894,125,16,0,216,353,3687
2014-04-09,83,2883,125,16,0,229,352,3688
2014-04-08,85,2863,125,16,0,244,358,3691
2014-04-07,84,2895,125,16,0,250,369,3739
2014-04-04,85,2906,125,16,0,245,371,3748
2014-04-03,85,2864,125,16,0,252,368,3710
2014-04-01,86,2865,126,16,0,262,359,3714
2014-03-31,86,2854,126,16,0,242,361,3685
2014-03-28,86,2824,126,16,0,267,360,3679
2014-03-27,86,2802,126,16,0,262,356,3648
2014-03-26,76,2793,126,16,0,270,361,3642
2014-03-25,75,2782,126,16,0,264,368,3631
2014-03-21,65,2785,126,16,0,264,365,3621
2014-03-20,45,2776,126,16,0,260,366,3589
2014-03-19,45,2752,126,16,0,272,368,3579
2014-03-18,61,2739,126,16,0,270,372,3584
2014-03-17,46,2731,126,16,0,263,354,3536
2014-03-14,46,2726,126,16,0,268,366,3548
2014-03-13,46,2715,126,16,0,284,366,3553
2014-03-12,49,2716,126,16,0,296,367,3570
2014-03-11,47,2692,126,16,0,308,342,3531
2014-03-10,47,2690,126,16,0,309,344,3532
2014-03-07,47,2679,127,16,0,317,348,3534
2014-03-06,48,2685,127,16,0,323,348,3547
2014-03-05,47,2700,127,16,0,333,355,3578
2014-02-28,48,2722,127,16,0,305,358,3576
2014-02-27,48,2724,128,16,0,350,368,3634
2014-02-26,46,2724,128,16,0,365,368,3647
2014-02-25,46,2745,128,16,0,358,365,3658
2014-02-24,46,2745,129,17,0,351,365,3653
2014-02-21,46,2773,130,17,0,354,366,3686
2014-02-20,46,2771,130,17,0,350,366,3680
2014-02-19,46,2764,130,17,0,360,368,3685
2014-02-18,46,2756,130,17,0,359,362,3670
2014-02-17,46,2754,130,17,0,350,368,3665
2014-02-14,46,2754,130,17,0,352,370,3669
2014-02-13,46,2763,130,17,0,346,371,3673
2014-02-12,45,2765,130,17,0,356,361,3674
2014-02-11,46,2763,130,17,0,383,359,3698
2014-02-10,46,2740,130,17,0,392,360,3685
2014-02-07,46,2731,130,17,0,394,359,3677
2014-02-06,47,2723,130,17,0,398,359,3674
2014-02-05,47,2711,131,17,0,401,352,3659
2014-02-04,47,2714,131,17,0,423,359,3691
2014-02-03,47,2709,131,17,0,427,361,3692
2014-01-31,47,2710,131,17,0,403,358,3666
2014-01-30,46,2715,130,17,0,427,361,3696
2014-01-29,46,2717,130,17,0,425,360,3695
2014-01-28,46,2715,131,17,0,412,361,3682
2014-01-27,46,2724,131,15,0,398,376,3690
2014-01-24,46,2732,131,15,0,391,376,3691
2014-01-23,46,2733,131,16,0,381,376,3683
2014-01-22,46,2750,132,17,0,383,377,3705
2014-01-21,46,2756,132,17,0,372,369,3692
2014-01-20,46,2756,133,17,0,354,370,3676
2014-01-17,46,2759,133,18,0,344,368,3668
2014-01-16,46,2759,133,18,0,332,365,3653
2014-01-15,46,2761,133,17,0,318,366,3641
2014-01-14,46,2769,134,18,0,303,366,3636
2014-01-13,45,2759,133,18,0,287,377,3619
2014-01-10,45,2782,133,18,0,280,380,3638
2014-01-09,45,2698,134,18,0,279,381,3555
2014-01-08,46,2714,134,18,0,288,383,3583
2014-01-07,32,2724,134,18,0,306,390,3604
2014-01-06,33,2711,134,18,0,295,396,3587
2014-01-03,33,2715,134,18,0,294,389,3583
2014-01-02,34,2723,134,18,0,296,395,3600
2013-12-30,41,2738,135,18,0,282,402,3616
2013-12-27,41,2730,134,18,0,300,380,3603
2013-12-26,41,2724,134,19,0,297,361,3576
2013-12-23,41,2730,135,19,0,330,368,3623
2013-12-20,40,2741,135,18,0,335,361,3630
2013-12-19,41,2769,135,18,0,334,363,3660
2013-12-18,41,2727,136,19,0,355,365,3643
2013-12-17,40,2730,137,19,0,352,364,3642
2013-12-16,40,2729,138,20,0,349,367,3643
2013-12-13,40,2758,130,20,0,350,367,3665
2013-12-12,40,2768,131,20,0,354,368,3681
2013-12-11,40,2774,131,20,0,359,369,3693
2013-12-10,44,2770,131,20,0,396,397,3758
2013-12-09,43,2772,131,20,0,407,397,3770
2013-12-06,43,2787,131,20,0,406,410,3797
2013-12-05,42,2793,131,20,0,405,405,3796
2013-12-04,44,2798,131,20,0,424,419,3836
2013-12-03,44,2790,131,20,0,446,398,3829
2013-12-02,44,2812,131,20,0,451,395,3853
2013-11-29,44,2810,131,20,0,408,393,3806
2013-11-28,44,2802,132,20,0,470,397,3865
2013-11-27,44,2808,132,20,0,475,397,3876
2013-11-26,43,2810,132,20,0,454,394,3853
2013-11-22,43,2828,134,20,0,456,397,3878
2013-11-21,35,2828,134,20,0,454,392,3863
2013-11-20,35,2850,134,20,0,466,392,3897
2013-11-19,35,2872,134,20,0,464,387,3912
2013-11-18,35,2876,134,21,0,451,384,3901
2013-11-15,34,2905,134,21,0,452,384,3930
2013-11-14,31,2897,134,21,0,453,394,3930
2013-11-13,32,2905,130,21,0,455,397,3940
2013-11-12,36,2925,130,21,0,485,397,3994
2013-11-11,36,2934,130,21,0,494,400,4015
2013-11-08,35,2937,130,21,0,494,398,4015
2013-11-07,35,2955,131,21,0,488,382,4012
2013-11-05,36,2961,131,21,0,527,377,4053
2013-11-04,36,2955,131,21,0,544,379,4066
2013-11-01,35,2954,132,21,0,560,383,4085
2013-10-31,35,2972,132,21,0,508,357,4025
2013-10-30,36,2975,132,21,0,569,384,4117
2013-10-29,36,2990,133,21,0,559,382,4121
2013-10-28,39,2998,133,21,0,547,377,4115
2013-10-25,39,2995,133,21,0,542,398,4128
2013-10-24,39,3011,133,21,0,532,402,4138
2013-10-23,39,3028,133,21,0,540,404,4165
2013-10-22,37,3023,133,21,0,529,418,4161
2013-10-21,37,3021,133,22,0,508,415,4136
2013-10-18,37,3031,133,23,0,498,420,4142
2013-10-17,36,3035,133,23,0,482,439,4148
2013-10-16,36,3045,133,23,0,472,443,4152
2013-10-15,36,3060,133,23,0,435,442,4129
2013-10-11,36,3068,133,23,0,426,440,4126
2013-10-10,36,3090,133,23,0,422,448,4152
2013-10-09,36,3074,133,23,0,421,446,4133
2013-10-08,39,3102,133,23,0,440,444,4181
2013-10-07,39,3105,133,23,0,446,444,4190
2013-10-04,38,3101,134,23,0,430,460,4186
2013-10-03,39,3110,134,23,0,424,445,4175
2013-10-02,40,3099,134,23,0,416,443,4155
2013-10-01,40,3099,134,23,0,434,419,4149
2013-09-30,38,3127,134,23,0,417,411,4150
2013-09-27,38,3125,134,23,0,443,442,4205
2013-09-26,38,3129,134,23,0,431,443,4198
2013-09-25,38,3119,134,23,0,433,442,4189
2013-09-24,38,3156,134,23,0,421,442,4214
2013-09-23,38,3200,134,23,0,409,444,4248
2013-09-20,37,3235,134,23,0,405,449,4283
2013-09-19,38,3236,135,23,0,399,451,4282
2013-09-18,37,3253,135,24,0,402,458,4309
2013-09-17,37,3250,135,24,0,391,458,4295
2013-09-16,37,3263,135,24,0,369,467,4295
2013-09-13,37,3263,135,24,0,366,492,4317
2013-09-12,36,3275,135,24,0,360,499,4329
2013-09-11,36,3278,136,25,0,357,498,4330
2013-09-10,39,3284,136,25,0,377,496,4357
2013-09-09,38,3294,136,25,0,378,496,4367
2013-09-06,38,3295,136,25,0,372,498,4364
2013-09-05,38,3287,136,25,0,369,496,4351
2013-09-04,37,3283,136,25,0,366,502,4349
2013-09-03,38,3321,136,25,0,390,502,4412
2013-09-02,38,3287,136,25,0,396,490,4372
2013-08-30,37,3323,136,25,0,363,489,4373
2013-08-29,37,3325,136,25,0,407,490,4420
2013-08-28,37,3332,136,25,0,415,480,4425
2013-08-27,37,3337,137,25,0,404,481,4421
2013-08-26,37,3347,138,25,0,394,483,4424
2013-08-23,36,3307,138,25,0,406,478,4390
2013-08-22,36,3322,138,25,0,395,478,4394
2013-08-21,36,3319,137,26,0,404,479,4401
2013-08-20,36,3340,137,26,0,383,476,4398
2013-08-16,36,3354,137,25,0,386,477,4415
2013-08-15,36,3369,137,26,0,390,469,4427
2013-08-14,36,3379,138,26,0,389,468,4436
2013-08-13,39,3377,138,26,0,417,474,4471
2013-08-12,38,3383,138,26,0,423,475,4483
2013-08-09,38,3398,138,26,0,417,479,4496
2013-08-08,38,3397,138,26,0,418,474,4491
2013-08-07,38,3404,138,26,0,416,464,4486
2013-08-06,39,3402,138,26,0,444,468,4517
2013-08-05,39,3388,138,26,0,460,465,4516
2013-08-02,39,3413,139,26,0,474,467,4558
2013-08-01,39,3403,139,26,0,470,468,4545
2013-07-31,38,3431,139,26,0,457,468,4559
2013-07-30,38,3432,139,26,0,473,467,4575
2013-07-29,39,3451,139,26,0,457,469,4581
2013-07-26,38,3501,140,26,0,464,472,4641
2013-07-25,38,3522,140,26,0,452,470,4648
2013-07-24,37,3523,140,26,0,457,474,4657
2013-07-23,38,3536,140,26,0,447,473,4660
2013-07-22,38,3550,140,26,0,436,474,4664
2013-07-19,38,3540,139,27,0,424,470,4638
2013-07-18,39,3576,139,27,0,412,474,4667
2013-07-17,39,3585,139,27,0,398,467,4655
2013-07-16,38,3614,140,27,0,388,467,4674
2013-07-15,38,3635,140,27,0,371,474,4685
2013-07-12,38,3669,141,27,0,368,484,4727
2013-07-11,38,3696,141,27,0,372,484,4758
2013-07-10,38,3715,141,27,0,386,487,4794
2013-07-08,41,3766,141,27,0,401,491,4867
2013-07-05,41,3777,140,27,0,396,491,4872
2013-07-04,41,3760,140,27,0,393,469,4830
2013-07-03,42,3771,140,27,0,404,454,4838
2013-07-02,42,3792,140,27,0,417,467,4885
2013-07-01,42,3805,141,27,0,409,471,4895
2013-06-28,42,3834,141,27,0,389,470,4903
2013-06-27,43,3827,140,27,0,435,493,4965
2013-06-26,43,3839,141,28,0,431,494,4976
2013-06-25,43,3853,142,28,0,422,494,4982
2013-06-24,41,3848,142,27,0,395,488,4941
2013-06-19,40,3853,143,28,0,384,491,4939
2013-06-18,40,3857,144,29,0,397,488,4955
2013-06-17,40,3855,146,29,0,396,481,4947
2013-06-14,40,3867,148,29,0,393,485,4962
2013-06-13,40,3869,148,29,0,391,489,4966
2013-06-12,40,3870,148,30,0,389,501,4978
2013-06-11,46,3870,149,30,0,411,500,5006
2013-06-10,45,3868,149,30,0,420,500,5012
2013-06-07,45,3875,149,30,0,420,503,5022
2013-06-06,45,3868,149,30,0,423,500,5015
2013-06-05,45,3873,149,30,0,420,502,5019
2013-06-04,47,3868,147,30,0,440,503,5035
2013-06-03,46,3874,147,30,0,454,515,5066
2013-05-31,46,3910,147,30,0,419,511,5063
2013-05-30,47,3914,147,30,0,467,521,5126
2013-05-29,47,3915,148,30,0,482,523,5145
2013-05-28,46,3899,149,30,0,470,521,5115
2013-05-27,45,3905,149,29,0,461,522,5111
2013-05-24,45,3917,149,29,0,453,525,5118
2013-05-23,45,3922,149,30,0,446,534,5126
2013-05-22,45,3923,149,30,0,456,534,5137
2013-05-21,44,3913,149,30,0,447,535,5118
2013-05-20,44,3905,149,30,0,427,538,5093
2013-05-17,44,3897,148,30,0,434,558,5111
2013-05-16,44,3906,148,30,0,435,554,5117
2013-05-15,43,3908,148,30,0,435,549,5113
2013-05-14,46,3896,148,30,0,458,549,5127
2013-05-13,46,3898,148,30,0,466,548,5136
2013-05-10,45,3896,148,30,0,465,553,5137
2013-05-09,46,3933,148,31,0,461,554,5173
2013-05-08,47,3956,148,31,0,474,564,5220
2013-05-07,47,3941,148,31,0,487,559,5213
2013-05-06,47,3949,149,31,0,516,550,5242
2013-05-03,46,3962,149,32,0,520,548,5257
2013-05-02,47,3968,149,32,0,508,541,5245
2013-04-30,52,3982,149,33,0,490,524,5230
2013-04-29,47,4037,149,32,0,508,536,5309
2013-04-26,46,4022,149,32,0,488,528,5265
2013-04-25,52,3993,149,32,0,479,529,5234
2013-04-24,52,4023,149,33,0,508,528,5293
2013-04-23,50,4029,150,33,0,506,531,5299
2013-04-22,51,4025,150,33,0,489,496,5244
2013-04-19,50,4037,150,33,0,482,491,5243
2013-04-18,51,4019,150,33,0,471,486,5210
2013-04-17,51,4004,150,33,0,463,490,5191
2013-04-16,58,3989,150,33,0,458,498,5186
2013-04-15,58,3971,150,33,0,444,499,5155
2013-04-12,58,3964,150,33,0,433,501,5139
2013-04-11,58,3930,150,33,0,428,505,5104
2013-04-10,58,3929,152,33,0,441,505,5118
2013-04-09,58,3888,152,33,0,452,508,5091
2013-04-08,62,3911,152,33,0,456,510,5124
2013-04-05,62,3932,152,33,0,458,519,5156
2013-04-04,61,3919,153,33,0,453,523,5142
2013-04-03,59,3926,153,32,0,406,521,5097
2013-03-27,58,3960,153,33,0,356,503,5063
2013-03-26,60,3925,153,33,0,413,518,5102
2013-03-25,60,3949,154,33,0,404,516,5116
2013-03-22,59,3967,154,33,0,406,515,5134
2013-03-21,59,3969,155,33,0,396,518,5130
2013-03-20,58,3972,155,33,0,406,508,5132
2013-03-19,63,3964,156,33,0,401,502,5119
2013-03-18,63,3964,158,34,0,419,516,5154
2013-03-15,62,3993,158,34,0,415,504,5166
2013-03-14,62,4006,158,34,0,413,508,5181
2013-03-13,62,4035,158,34,0,406,505,5200
2013-03-12,66,4040,158,34,0,409,506,5213
2013-03-11,65,4028,158,34,0,427,508,5220
2013-03-08,66,4065,159,34,0,427,509,5260
2013-03-07,66,4059,159,34,0,423,511,5252
2013-03-06,66,4049,159,34,0,425,512,5245
2013-03-05,66,4077,159,34,0,446,512,5294
2013-03-04,66,4093,159,34,0,467,513,5332
2013-03-01,63,4104,159,34,0,478,509,5347
2013-02-28,64,4096,159,34,0,426,508,5287
2013-02-27,65,4097,158,34,0,494,509,5357
2013-02-26,65,4119,159,34,0,486,511,5374
2013-02-25,66,4126,159,34,0,486,508,5379
2013-02-22,66,4136,159,34,0,484,507,5386
2013-02-21,67,4171,160,34,0,468,504,5404
2013-02-19,66,4162,160,34,0,476,507,5405
2013-02-18,67,4168,160,34,0,461,501,5391
2013-02-15,66,4188,160,35,0,456,499,5404
2013-02-14,67,4189,160,35,0,468,499,5418
2013-02-13,66,4226,160,35,0,457,508,5452
2013-02-08,68,4261,160,35,0,457,509,5490
2013-02-07,68,4285,160,35,0,451,509,5508
2013-02-06,66,4277,160,35,0,451,510,5499
2013-02-05,66,4314,160,35,0,457,505,5537
2013-02-04,66,4324,160,35,0,461,506,5552
2013-02-01,66,4336,161,35,0,446,502,5546
2013-01-30,74,4339,161,35,0,414,491,5514
2013-01-29,74,4325,160,35,0,424,502,5520
2013-01-28,74,4328,160,35,0,401,502,5500
2013-01-25,74,4393,160,35,0,387,500,5549
2013-01-24,74,4372,161,35,0,376,500,5518
2013-01-23,74,4358,161,35,0,370,500,5498
2013-01-22,74,4345,159,35,0,353,495,5461
2013-01-21,74,4307,160,36,0,335,496,5408
2013-01-18,73,4298,160,36,0,322,495,5384
2013-01-17,73,4286,160,36,0,310,494,5359
2013-01-16,73,4289,160,36,0,297,493,5348
2013-01-15,73,4306,161,36,0,284,497,5357
2013-01-14,73,4336,161,36,0,264,494,5364
2013-01-11,73,4340,161,36,0,259,526,5395
2013-01-10,73,4357,162,37,0,261,531,5421
2013-01-09,73,4376,162,37,0,264,532,5444
2013-01-08,74,4367,161,37,0,262,502,5403
2013-01-07,74,4397,161,37,0,250,502,5421
2013-01-04,74,4412,161,37,0,240,503,5427
2013-01-03,73,4415,161,37,0,240,503,5429
2013-01-02,73,4407,161,37,0,242,508,5428
2012-12-31,74,4448,162,37,0,223,487,5431
2012-12-28,74,4434,162,37,0,239,504,5450
2012-12-27,73,4433,162,37,0,235,506,5446
2012-12-26,74,4523,162,37,0,234,505,5535
2012-12-21,73,4531,163,38,0,229,506,5540
2012-12-20,73,4487,163,38,0,228,507,5496
2012-12-19,73,4491,164,38,0,227,515,5508
2012-12-18,73,4499,165,39,0,224,513,5513
2012-12-17,72,4481,167,39,0,221,516,5496
2012-12-14,73,4539,170,39,0,220,526,5567
2012-12-13,73,4547,168,39,0,218,525,5570
2012-12-12,72,4545,168,39,0,217,520,5561
2012-12-11,74,4539,168,39,0,233,517,5570
2012-12-10,74,4558,168,39,0,240,515,5594
2012-12-07,74,4582,169,39,0,235,519,5618
2012-12-06,74,4580,169,39,0,241,522,5625
2012-12-05,74,4588,169,39,0,246,512,5628
2012-12-04,75,4576,169,39,0,255,505,5619
2012-12-03,75,4574,169,39,0,256,493,5606
2012-11-30,74,4564,169,39,0,232,497,5575
2012-11-29,74,4582,170,39,0,260,501,5626
2012-11-28,75,4581,171,39,0,263,499,5628
2012-11-27,75,4568,171,39,0,255,500,5608
2012-11-23,75,4547,171,39,0,251,500,5583
2012-11-22,75,4546,172,39,0,252,497,5581
2012-11-21,76,4531,172,40,0,252,495,5566
2012-11-20,76,4539,172,40,0,250,498,5575
2012-11-19,76,4530,172,40,0,243,497,5558
2012-11-16,81,4555,173,40,0,244,504,5597
2012-11-15,81,4533,172,40,0,246,513,5585
2012-11-14,82,4540,172,40,0,249,516,5599
2012-11-13,83,4554,172,40,0,274,519,5642
2012-11-12,83,4557,172,40,0,282,520,5654
2012-11-09,83,4571,172,41,0,281,522,5670
2012-11-08,84,4555,172,41,0,284,523,5659
2012-11-07,87,4559,172,41,0,299,521,5679
2012-11-05,89,4545,172,41,0,314,524,5685
2012-11-02,88,4597,173,41,0,335,525,5759
2012-11-01,88,4650,173,41,0,336,527,5815
2012-10-31,88,4635,173,41,0,307,528,5772
2012-10-30,88,4656,173,41,0,342,521,5821
2012-10-29,88,4656,174,40,0,337,521,5816
2012-10-26,88,4645,174,41,0,335,521,5804
2012-10-25,92,4659,173,41,0,334,523,5822
2012-10-24,92,4687,173,41,0,336,522,5851
2012-10-23,92,4698,173,41,0,327,519,5850
2012-10-22,92,4713,173,41,0,322,521,5862
2012-10-19,91,4751,173,41,0,317,532,5905
2012-10-18,92,4739,173,41,0,311,537,5893
2012-10-17,95,4749,173,41,0,305,535,5898
2012-10-16,95,4754,173,41,0,299,536,5898
2012-10-15,95,4797,174,42,0,291,538,5937
2012-10-12,95,4803,173,42,0,288,538,5939
2012-10-11,95,4794,173,42,0,291,534,5929
2012-10-10,96,4817,174,42,0,294,530,5953
2012-10-09,96,4856,174,42,0,314,523,6005
2012-10-05,98,4842,174,42,0,321,523,6000
2012-10-04,98,4872,174,42,0,321,529,6036
2012-10-03,98,4876,174,42,0,325,528,6043
2012-10-02,99,4900,173,42,0,342,518,6074
2012-10-01,99,4922,173,42,0,355,520,6111
2012-09-28,100,4939,174,42,0,348,523,6126
2012-09-27,100,4953,171,42,0,368,536,6170
2012-09-26,100,4981,171,42,0,374,525,6193
2012-09-25,101,4983,172,42,0,377,529,6204
2012-09-21,111,5005,172,42,0,374,540,6244
2012-09-20,101,5026,172,42,0,375,547,6263
2012-09-19,102,5014,172,42,0,382,543,6255
2012-09-18,101,5043,172,42,0,386,546,6290
2012-09-17,102,5017,172,43,0,382,551,6267
2012-09-14,102,5073,172,43,0,388,552,6330
2012-09-13,101,5069,172,42,0,393,553,6330
2012-09-12,101,5073,172,43,0,395,554,6338
2012-09-11,102,5083,172,43,0,409,559,6368
2012-09-10,102,5086,172,43,0,429,559,6391
2012-09-07,107,5121,172,43,0,429,557,6429
2012-09-06,107,5136,172,43,0,431,562,6451
2012-09-05,108,5160,172,43,0,439,556,6478
2012-09-04,110,5200,172,43,0,448,565,6538
2012-09-03,111,5208,172,43,0,462,566,6562
2012-08-31,110,5190,173,43,0,450,570,6536
2012-08-30,111,5223,173,44,0,457,568,6576
2012-08-29,114,5260,172,44,0,462,571,6623
2012-08-28,114,5272,173,44,0,452,571,6626
2012-08-27,114,5294,173,44,0,446,577,6648
2012-08-24,118,5325,173,44,0,443,579,6682
2012-08-23,118,5354,173,44,0,442,582,6713
2012-08-22,121,5358,173,44,0,440,584,6720
2012-08-21,121,5405,173,45,0,424,592,6760
2012-08-17,121,5421,173,45,0,420,596,6776
2012-08-16,121,5425,173,45,0,413,598,6775
2012-08-15,121,5433,173,45,0,405,600,6777
2012-08-14,122,5467,173,45,0,394,600,6801
2012-08-13,122,5513,173,46,0,381,599,6834
2012-08-10,122,5527,173,46,0,380,595,6843
2012-08-09,122,5510,173,46,0,382,607,6840
2012-08-08,123,5535,173,46,0,382,603,6862
2012-08-07,124,5595,173,46,0,392,605,6935
2012-08-06,124,5622,173,45,0,399,610,6973
2012-08-03,124,5657,174,45,0,393,612,7005
2012-08-02,124,5678,174,45,0,393,613,7027
2012-08-01,124,5697,174,45,0,392,617,7049
2012-07-31,125,5788,174,45,0,401,618,7151
2012-07-30,125,5825,173,43,0,400,622,7188
2012-07-27,125,5843,173,43,0,393,622,7199
2012-07-26,125,5913,174,43,0,382,622,7259
2012-07-25,125,5958,174,43,0,380,625,7305
2012-07-24,124,6012,174,43,0,370,628,7351
2012-07-23,125,6052,173,42,0,362,631,7385
2012-07-20,126,6099,174,42,0,353,651,7445
2012-07-19,124,6159,174,43,0,346,655,7501
2012-07-18,124,6189,174,43,0,350,654,7534
2012-07-17,125,6225,175,43,0,344,660,7572
2012-07-16,131,6247,176,42,0,336,660,7592
2012-07-13,132,6250,176,42,0,332,663,7595
2012-07-12,128,6309,176,42,0,333,658,7646
2012-07-11,128,6368,176,42,0,336,654,7704
2012-07-10,127,6417,177,42,0,337,663,7763
2012-07-06,128,6471,177,42,0,343,665,7826
2012-07-05,128,6523,177,42,0,344,675,7889
2012-07-04,127,6599,177,42,0,346,674,7965
2012-07-03,127,6611,177,41,0,355,675,7986
2012-07-02,127,6670,176,42,0,366,676,8057
2012-06-29,127,6691,176,42,0,352,677,8065
2012-06-28,127,6693,176,40,0,366,689,8091
2012-06-27,127,6720,176,41,0,365,688,8117
2012-06-26,126,6778,175,41,0,357,690,8167
2012-06-25,126,6814,175,41,0,352,691,8199
2012-06-22,127,6842,175,41,0,357,691,8233
2012-06-21,127,6892,175,41,0,341,697,8273
2012-06-19,127,6950,176,41,0,342,696,8332
2012-06-18,128,7039,177,40,0,336,698,8418
2012-06-15,129,7042,178,40,0,336,702,8427
2012-06-14,129,7094,180,41,0,338,702,8484
2012-06-13,129,7149,181,41,0,336,699,8535
2012-06-12,129,7219,181,40,0,347,710,8626
2012-06-11,129,7252,181,40,0,353,708,8663
2012-06-08,131,7284,181,40,0,353,718,8707
2012-06-07,129,7328,181,41,0,350,724,8753
2012-06-06,129,7372,181,40,0,357,730,8809
2012-06-05,130,7383,181,40,0,360,730,8824
2012-06-04,130,7416,181,40,0,374,728,8869
2012-06-01,130,7466,183,40,0,374,725,8918
2012-05-31,130,7510,183,40,0,356,724,8943
2012-05-30,131,7565,186,40,0,368,715,9005
2012-05-29,131,7599,186,40,0,359,712,9027
2012-05-28,131,7616,188,40,0,329,713,9017
2012-05-24,131,7632,190,40,0,341,714,9048
2012-05-23,135,7641,191,39,0,341,706,9053
2012-05-22,142,7636,191,38,0,334,706,9047
2012-05-21,141,7658,191,38,0,329,713,9070
2012-05-18,141,7698,191,38,0,321,713,9102
2012-05-17,142,7759,192,38,0,316,720,9167
2012-05-16,143,7800,192,38,0,312,719,9204
2012-05-15,143,7823,192,38,0,309,709,9214
2012-05-14,143,7860,192,38,0,299,712,9244
2012-05-11,146,7875,192,38,0,300,716,9267
2012-05-10,148,7871,192,38,0,302,711,9262
2012-05-09,151,7914,192,38,0,305,711,9311
2012-05-08,145,7884,192,38,0,313,706,9278
2012-05-07,153,7885,192,38,0,307,707,9282
2012-05-04,154,7925,193,38,0,300,711,9321
2012-05-03,155,7965,193,38,0,303,711,9365
2012-05-02,156,7973,193,38,0,296,706,9362
2012-04-27,157,7965,193,38,0,306,708,9367
2012-04-26,157,7981,200,38,0,310,719,9405
2012-04-25,157,7968,199,38,0,304,711,9377
2012-04-24,157,7976,199,38,0,299,713,9382
2012-04-23,160,7983,199,38,0,296,714,9390
2012-04-20,160,8015,199,36,0,302,715,9427
2012-04-19,161,8005,199,36,0,300,724,9425
2012-04-18,162,7998,199,36,0,299,726,9420
2012-04-17,162,8032,199,36,0,294,729,9452
2012-04-16,162,8038,199,36,0,287,733,9455
2012-04-13,161,8048,200,35,0,287,738,9469
2012-04-12,158,8093,200,35,0,282,740,9508
2012-04-11,149,8060,199,35,0,282,741,9466
2012-04-10,149,8051,199,35,0,282,743,9459
2012-04-09,150,8037,198,35,0,279,741,9440
2012-04-04,152,8043,197,35,0,277,740,9444
2012-04-03,153,8077,197,35,0,281,740,9483
2012-03-30,147,8094,197,36,0,282,738,9494
2012-03-29,133,8078,197,34,0,295,743,9480
2012-03-28,134,8075,198,35,0,295,752,9489
2012-03-27,135,8071,198,36,0,291,745,9476
2012-03-26,135,8085,198,36,0,284,744,9482
2012-03-23,135,8108,198,36,0,284,742,9503
2012-03-22,136,8053,198,35,0,286,745,9453
2012-03-21,136,8065,198,34,0,288,743,9464
2012-03-20,137,8055,196,34,0,285,739,9446
2012-03-19,138,8010,196,34,0,279,739,9396
2012-03-16,137,8044,196,34,0,281,737,9429
2012-03-15,138,8019,196,34,0,288,745,9420
2012-03-14,138,8047,195,33,0,292,744,9449
2012-03-13,138,8022,195,33,0,303,751,9442
2012-03-12,138,8016,195,33,0,318,757,9457
2012-03-09,139,8023,195,33,0,316,760,9466
2012-03-08,139,8037,195,33,0,316,755,9475
2012-03-07,139,8029,195,33,0,325,754,9475
2012-03-06,139,8060,195,33,0,332,755,9514
2012-03-05,139,8069,195,33,0,345,755,9536
2012-03-02,141,8058,194,33,0,347,755,9528
2012-03-01,135,8064,194,33,0,343,762,9531
2012-02-29,135,8070,194,33,0,336,759,9527
2012-02-28,138,8107,194,33,0,337,756,9565
2012-02-24,138,8120,194,33,0,333,756,9574
2012-02-23,136,8155,194,33,0,328,767,9613
2012-02-22,136,8165,194,33,0,317,767,9612
2012-02-17,138,8229,194,33,0,314,770,9678
2012-02-16,137,8284,194,32,0,309,770,9726
2012-02-15,137,8249,194,32,0,300,771,9683
2012-02-14,137,8238,193,32,0,293,781,9674
2012-02-13,137,8242,193,32,0,285,785,9674
2012-02-10,138,8246,194,32,0,281,788,9679
2012-02-09,138,8242,194,32,0,282,793,9681
2012-02-08,138,8252,194,32,0,281,795,9692
2012-02-07,138,8241,194,32,0,287,791,9683
2012-02-06,139,8235,194,32,0,288,796,9684
2012-02-03,139,8249,194,32,0,283,788,9685
2012-02-02,139,8245,194,32,0,282,791,9683
2012-02-01,140,8212,195,32,0,281,786,9646
2012-01-31,139,8204,195,32,0,281,781,9632
2012-01-30,140,8233,195,32,0,280,782,9662
2012-01-27,140,8211,195,33,0,272,786,9637
2012-01-26,140,8207,196,33,0,263,790,9629
2012-01-25,140,8197,195,32,0,258,791,9613
2012-01-24,140,8198,195,32,0,253,774,9592
2012-01-23,141,8185,195,32,0,245,783,9581
2012-01-20,144,8185,195,32,0,237,791,9584
2012-01-19,144,8154,195,32,0,229,788,9542
2012-01-18,144,8136,194,31,0,226,786,9517
2012-01-17,144,8135,195,31,0,221,789,9515
2012-01-16,145,8139,195,31,0,215,789,9514
2012-01-13,145,8157,194,32,0,209,793,9530
2012-01-12,144,8102,194,21,0,207,792,9460
2012-01-11,144,8100,194,32,0,204,793,9467
2012-01-10,144,8054,194,32,0,205,790,9419
2012-01-09,145,8038,194,32,0,208,794,9411
2012-01-06,146,8009,194,32,0,204,801,9386
2012-01-05,146,8016,194,32,0,203,799,9390
2012-01-04,146,7991,194,32,0,202,801,9366
2012-01-03,146,7962,195,32,0,203,794,9332
2011-12-30,145,7993,195,32,0,201,807,9373
2011-12-29,146,8020,196,32,0,204,807,9405
2011-12-28,146,7994,196,32,0,206,808,9382
2011-12-27,147,7966,196,32,0,207,820,9368
2011-12-23,147,7991,197,32,0,205,853,9425
2011-12-22,146,8016,197,32,0,203,860,9454
2011-12-21,144,8012,197,32,0,203,850,9438
2011-12-20,145,8074,197,33,0,228,853,9530
2011-12-19,143,8104,198,33,0,197,863,9538
2011-12-16,143,8132,199,33,0,210,857,9574
2011-12-15,143,8134,200,33,0,213,852,9575
2011-12-14,142,8124,201,33,0,210,851,9561
2011-12-13,150,8132,201,33,0,216,845,9577
2011-12-12,156,8145,201,33,0,213,848,9596
2011-12-07,147,8154,201,33,0,213,862,9610
2011-12-06,163,8164,196,33,0,219,869,9644
2011-12-05,156,8200,197,33,0,224,870,9680
2011-12-02,142,8208,197,33,0,226,874,9680
2011-12-01,145,8222,197,34,0,223,876,9697
2011-11-30,137,8219,196,33,0,218,877,9680
2011-11-29,150,8275,197,34,0,218,876,9750
2011-11-25,135,8290,198,34,0,215,879,9751
2011-11-24,133,8315,198,34,0,212,882,9774
2011-11-23,133,8330,198,33,0,211,877,9782
2011-11-22,131,8340,198,33,0,209,872,9783
2011-11-21,125,8373,198,33,0,206,874,9809
2011-11-18,115,8398,199,33,0,203,905,9853
2011-11-17,118,8424,200,34,0,199,907,9882
2011-11-16,117,8427,200,34,0,196,911,9885
2011-11-15,117,8424,200,34,0,192,910,9877
2011-11-14,128,8393,200,34,0,189,909,9853
2011-11-11,128,8369,200,34,0,189,910,9830
2011-11-10,128,8359,202,34,0,190,912,9825
2011-11-09,128,8359,202,34,0,189,915,9827
2011-11-08,129,8344,202,34,0,196,917,9822
2011-11-07,130,8351,202,34,0,199,918,9834
2011-11-04,129,8387,202,34,0,199,915,9866
2011-11-03,129,8400,202,34,0,199,916,9880
2011-11-02,128,8395,202,34,0,200,909,9868
2011-11-01,128,8321,202,34,0,204,903,9792
2011-10-31,128,8285,202,34,0,206,901,9756
2011-10-28,130,8280,202,34,0,209,902,9757
2011-10-27,130,8261,202,34,0,207,911,9745
2011-10-26,129,8237,202,34,0,207,919,9728
2011-10-25,119,8218,200,34,0,204,930,9705
2011-10-24,119,8209,200,33,0,203,937,9701
2011-10-21,119,8175,200,33,0,198,923,9648
2011-10-20,119,8175,200,34,0,196,927,9651
2011-10-19,119,8160,200,34,0,196,927,9636
2011-10-18,119,8134,200,34,0,195,928,9610
2011-10-17,119,8150,200,34,0,192,923,9618
2011-10-14,119,8150,200,34,0,191,928,9622
2011-10-13,119,8125,200,34,0,192,934,9604
2011-10-12,120,8145,200,34,0,194,939,9632
2011-10-11,119,8124,200,34,0,193,939,9609
2011-10-07,120,8120,200,34,0,197,940,9611
2011-10-06,121,8124,200,34,0,197,942,9618
2011-10-05,120,8102,201,34,0,196,944,9597
2011-10-04,120,8066,201,34,0,199,931,9551
2011-10-03,120,8092,201,34,0,205,930,9582
2011-09-30,117,8077,201,34,0,199,927,9555
2011-09-29,119,8232,202,34,0,203,809,9599
2011-09-28,117,8173,202,34,0,200,811,9537
2011-09-27,116,8201,202,35,0,195,825,9574
2011-09-26,116,8191,202,35,0,192,826,9562
2011-09-23,116,8222,202,35,0,192,822,9589
2011-09-22,116,8215,200,35,0,188,822,9576
2011-09-21,117,8233,200,35,0,187,822,9594
2011-09-20,117,8195,201,35,0,183,823,9554
2011-09-19,116,8214,201,35,0,180,820,9566
2011-09-16,116,8215,201,36,0,180,821,9569
2011-09-15,116,8220,201,36,0,181,818,9572
2011-09-14,116,8205,201,36,0,180,823,9561
2011-09-13,105,8219,201,36,0,187,820,9568
2011-09-12,106,8187,201,36,0,189,827,9546
2011-09-09,106,8185,202,36,0,189,809,9527
2011-09-08,106,8150,202,36,0,188,816,9498
2011-09-07,105,8162,202,36,0,189,805,9499
2011-09-06,106,8183,203,36,0,192,808,9528
2011-09-05,105,8152,203,36,0,198,821,9515
2011-09-02,105,8158,202,36,0,201,821,9523
2011-09-01,105,8147,203,36,0,200,815,9506
2011-08-31,104,8107,203,36,0,194,814,9458
2011-08-30,105,8137,203,36,0,195,805,9481
2011-08-29,104,8166,203,36,0,196,782,9487
2011-08-26,105,8124,203,36,0,198,798,9464
2011-08-25,104,8103,201,36,0,194,801,9439
2011-08-24,104,8117,201,36,0,194,799,9451
2011-08-23,104,8089,201,36,0,188,796,9414
2011-08-19,105,8066,201,37,0,184,807,9400
2011-08-18,105,8059,201,37,0,181,804,9387
2011-08-17,105,8064,201,37,0,178,804,9389
2011-08-16,105,8085,201,37,0,175,803,9406
2011-08-15,104,8108,201,38,0,173,802,9426
2011-08-12,103,8047,201,38,0,170,797,9356
2011-08-11,103,8008,201,38,0,173,793,9316
2011-08-10,104,7979,201,38,0,173,791,9286
2011-08-09,103,7916,201,38,0,179,793,9230
2011-08-08,103,7949,202,38,0,182,790,9264
2011-08-05,103,7929,202,38,0,179,793,9244
2011-08-04,102,7921,203,38,0,180,787,9231
2011-08-03,102,7918,203,38,0,181,783,9225
2011-08-02,101,7893,203,38,0,184,776,9195
2011-08-01,101,7873,204,38,0,188,780,9184
2011-07-29,102,7852,204,38,0,182,786,9164
2011-07-28,103,7870,204,38,0,184,780,9179
2011-07-27,101,7877,204,39,0,182,791,9194
2011-07-26,101,7860,205,26,0,178,784,9154
2011-07-25,101,7872,205,39,0,175,785,9177
2011-07-22,101,7864,205,39,0,173,790,9172
2011-07-21,94,7852,205,37,0,169,785,9142
2011-07-20,93,7826,205,37,0,168,776,9105
2011-07-19,97,7835,205,37,0,167,781,9122
2011-07-18,97,7836,205,37,0,165,776,9116
2011-07-15,97,7840,205,38,0,163,771,9114
2011-07-14,91,7826,205,39,0,165,757,9083
2011-07-13,90,7816,205,39,0,164,770,9084
2011-07-12,90,7757,205,39,0,171,779,9041
2011-07-11,91,7730,205,39,0,180,766,9011
2011-07-08,90,7703,206,39,0,183,767,8988
2011-07-07,90,7711,206,39,0,184,759,8989
2011-07-06,91,7682,205,39,0,186,753,8956
2011-07-05,90,7671,206,39,0,190,745,8941
2011-07-04,90,7633,206,39,0,199,743,8910
2011-07-01,90,7647,206,39,0,200,744,8926
2011-06-30,90,7603,204,39,0,193,736,8865
2011-06-29,93,7637,205,39,0,198,723,8895
2011-06-28,92,7631,206,39,0,196,725,8889
2011-06-27,87,7623,206,39,0,193,720,8868
2011-06-24,86,7657,206,40,0,192,719,8900
2011-06-23,86,7639,206,39,0,191,715,8876
2011-06-22,85,7639,207,40,0,187,716,8874
2011-06-21,86,7633,207,40,0,185,711,8862
2011-06-17,86,7612,207,41,0,181,708,8835
2011-06-16,85,7613,207,41,0,177,711,8834
2011-06-15,85,7572,207,41,0,176,707,8788
2011-06-14,85,7535,212,41,0,173,695,8741
2011-06-13,84,7533,212,41,0,170,693,8733
2011-06-10,84,7520,212,42,0,168,695,8721
2011-06-09,84,7533,213,42,0,171,693,8736
2011-06-08,84,7466,214,42,0,172,695,8673
2011-06-07,91,7480,214,41,0,178,690,8694
2011-06-06,91,7465,214,41,0,180,687,8678
2011-06-03,83,7498,214,41,0,179,687,8702
2011-06-02,83,7465,214,42,0,180,687,8671
2011-06-01,83,7438,213,42,0,182,660,8618
2011-05-31,83,7412,200,41,0,186,668,8590
2011-05-30,84,7472,200,42,0,185,662,8645
2011-05-27,84,7471,200,29,0,182,662,8628
2011-05-26,83,7484,200,42,0,176,633,8618
2011-05-24,83,7486,200,42,0,174,626,8611
2011-05-23,83,7494,200,42,0,171,626,8616
2011-05-20,86,7507,200,42,0,169,614,8618
2011-05-19,84,7507,200,42,0,166,611,8610
2011-05-18,84,7556,201,42,0,164,600,8647
2011-05-17,84,7540,201,43,0,162,594,8624
2011-05-16,85,7554,201,43,0,160,595,8638
2011-05-13,85,7550,201,43,0,157,598,8634
2011-05-12,86,7544,198,43,0,161,590,8622
2011-05-11,86,7501,198,43,0,163,584,8575
2011-05-10,86,7481,198,42,0,168,589,8564
2011-05-09,86,7456,198,42,0,171,592,8545
2011-05-06,86,7441,199,42,0,170,589,8527
2011-05-05,86,7438,199,42,0,168,592,8525
2011-05-04,85,7412,199,42,0,169,588,8495
2011-05-03,85,7407,199,42,0,172,591,8496
2011-05-02,85,7386,200,42,0,174,588,8475
2011-04-29,84,7375,200,42,0,174,594,8469
2011-04-28,85,7468,200,42,0,174,604,8573
2011-04-27,84,7445,207,42,0,170,653,8601
2011-04-26,85,7429,207,42,0,162,664,8589
2011-04-25,87,7458,207,42,0,161,663,8618
2011-04-20,85,7469,207,42,0,157,662,8622
2011-04-19,84,7480,207,42,0,159,667,8639
2011-04-18,84,7474,207,42,0,158,637,8602
2011-04-15,85,7487,205,43,0,156,636,8612
2011-04-14,85,7476,205,43,0,159,638,8606
2011-04-13,71,7431,205,43,0,161,590,8501
2011-04-12,71,7430,205,43,0,165,591,8505
2011-04-11,71,7414,205,43,0,169,590,8492
2011-04-08,79,7403,206,43,0,169,593,8493
2011-04-07,63,7347,206,43,0,167,594,8420
2011-04-06,64,7270,206,43,0,168,594,8345
2011-04-05,64,7228,206,43,0,170,590,8301
2011-04-04,63,7234,206,43,0,172,586,8304
2011-04-01,63,7216,206,43,0,176,592,8296
2011-03-31,62,7181,204,43,0,169,586,8245
2011-03-30,69,7194,209,43,0,173,578,8266
2011-03-29,68,7235,208,43,0,167,567,8288
2011-03-28,68,7204,209,44,0,163,563,8251
2011-03-23,69,7208,208,44,0,161,568,8258
2011-03-22,68,7203,209,44,0,162,563,8249
2011-03-21,76,7172,209,44,0,165,564,8230
2011-03-18,75,7189,207,44,0,167,563,8245
2011-03-17,67,7167,208,44,0,170,563,8219
2011-03-16,67,7130,208,44,0,175,559,8183
2011-03-15,65,7120,208,45,0,183,552,8173
2011-03-14,68,7088,208,45,0,188,554,8151
2011-03-11,71,7085,208,45,0,187,553,8149
2011-03-10,71,7097,209,45,0,190,553,8165
2011-03-09,70,7046,210,45,0,189,552,8112
2011-03-04,68,7016,210,45,0,201,556,8096
2011-03-03,67,7009,210,31,0,200,557,8074
2011-03-02,67,6985,210,45,0,198,556,8061
2011-03-01,68,6963,210,45,0,197,552,8035
2011-02-28,68,6953,210,45,0,192,558,8026
2011-02-25,69,6954,210,45,0,194,555,8027
2011-02-24,75,6939,210,46,0,190,551,8011
2011-02-23,71,6938,208,46,0,187,551,8001
2011-02-22,72,6945,208,46,0,187,553,8011
2011-02-21,71,6920,208,46,0,184,549,7978
2011-02-18,73,6914,208,46,0,182,550,7973
2011-02-17,73,6910,208,46,0,179,553,7969
2011-02-16,74,6901,208,46,0,175,551,7955
2011-02-15,73,6836,208,47,0,171,550,7885
2011-02-14,73,6825,208,47,0,167,550,7870
2011-02-11,73,6847,208,47,0,170,558,7903
2011-02-10,73,6919,208,47,0,173,566,7986
2011-02-09,73,6833,208,47,0,172,562,7895
2011-02-08,73,6834,208,47,0,172,562,7896
2011-02-07,73,6802,208,47,0,173,563,7866
2011-02-04,74,6805,209,47,0,171,562,7868
2011-02-03,73,6790,209,47,0,169,563,7851
2011-02-02,73,6779,209,47,0,168,558,7834
2011-02-01,74,6753,209,47,0,170,559,7812
2011-01-31,74,6750,209,47,0,170,558,7808
2011-01-28,76,6732,209,48,0,168,552,7785
2011-01-27,76,6675,209,48,0,162,548,7718
2011-01-26,76,6682,209,48,0,159,546,7720
2011-01-25,76,6678,209,48,0,154,559,7724
2011-01-24,77,6646,209,48,0,151,563,7694
2011-01-21,76,6641,209,48,0,146,559,7679
2011-01-20,75,6637,209,48,0,142,557,7668
2011-01-19,75,6634,209,48,0,139,562,7667
2011-01-18,75,6630,208,48,0,137,562,7660
2011-01-17,76,6615,207,49,0,133,564,7644
2011-01-14,76,6621,206,47,0,129,565,7644
2011-01-13,75,6576,206,48,0,129,583,7617
2011-01-12,76,6574,207,47,0,127,583,7614
2011-01-11,76,6536,204,47,0,129,582,7574
2011-01-10,73,6540,204,47,0,130,579,7573
2011-01-07,74,6538,204,47,0,128,583,7574
2011-01-06,73,6480,205,47,0,126,584,7515
2011-01-05,74,6447,205,47,0,124,583,7480
2011-01-04,74,6391,204,47,0,123,585,7424
2011-01-03,74,6401,205,47,0,125,574,7426
2010-12-30,74,6345,205,47,0,123,579,7373
2010-12-29,74,6397,205,47,0,125,572,7420
2010-12-28,74,6348,204,47,0,124,569,7366
2010-12-27,74,6389,204,48,0,122,566,7403
2010-12-23,75,6410,204,48,0,123,564,7424
2010-12-22,74,6398,205,48,0,122,562,7409
2010-12-21,75,6354,205,48,0,121,564,7367
2010-12-20,74,6320,205,48,0,123,548,7318
2010-12-17,81,6331,206,48,0,125,548,7339
2010-12-16,78,6305,206,48,0,126,547,7310
2010-12-15,76,6288,205,48,0,127,540,7284
2010-12-14,76,6247,209,48,0,132,540,7252
2010-12-13,76,6252,211,48,0,137,536,7260
2010-12-10,76,6211,212,48,0,135,535,7217
2010-12-09,77,6175,212,48,0,137,534,7183
2010-12-07,77,6139,212,48,0,138,529,7143
2010-12-06,77,6092,212,48,0,144,528,7101
2010-12-03,78,6045,212,48,0,146,527,7056
2010-12-02,78,6039,212,48,0,145,524,7046
2010-12-01,76,5991,210,48,0,144,511,6980
2010-11-30,76,5969,210,48,0,141,508,6952
2010-11-29,76,5964,211,48,0,141,506,6946
2010-11-26,77,6010,211,48,0,140,513,6999
2010-11-25,78,5983,210,48,0,139,512,6970
2010-11-24,77,5964,209,48,0,137,510,6945
2010-11-23,82,5953,209,48,0,135,514,6941
2010-11-19,84,5982,209,48,0,133,511,6967
2010-11-18,84,5963,209,49,0,131,510,6946
2010-11-17,90,5936,209,49,0,129,524,6937
2010-11-16,89,5936,209,49,0,127,523,6933
2010-11-15,90,5931,209,49,0,125,515,6919
2010-11-12,90,5933,209,49,0,124,501,6906
2010-11-11,91,5946,208,49,0,127,500,6921
2010-11-10,90,5950,208,49,0,127,487,6911
2010-11-09,91,5951,208,49,0,133,480,6912
2010-11-08,91,5917,208,49,0,137,475,6877
2010-11-05,89,5875,209,49,0,136,478,6836
2010-11-04,89,5884,209,50,0,141,478,6851
2010-11-03,89,5879,209,50,0,142,477,6846
2010-11-02,90,5846,208,50,0,143,477,6814
2010-11-01,89,5823,208,50,0,148,464,6782
2010-10-29,89,5795,209,50,0,141,471,6755
2010-10-28,88,5716,208,51,0,144,491,6698
2010-10-26,91,5711,208,51,0,143,486,6690
2010-10-25,88,5696,208,51,0,142,486,6671
2010-10-22,88,5724,209,51,0,140,484,6696
2010-10-21,89,5742,209,51,0,138,479,6708
2010-10-20,88,5716,209,51,0,137,478,6679
2010-10-19,87,5690,209,51,0,137,477,6651
2010-10-18,87,5652,209,51,0,136,481,6616
2010-10-15,89,5651,209,51,0,133,480,6613
2010-10-14,88,5600,209,51,0,136,461,6545
2010-10-13,88,5582,209,51,0,138,464,6532
2010-10-12,87,5580,209,51,0,139,461,6527
2010-10-08,87,5570,209,51,0,144,459,6520
2010-10-07,87,5567,209,51,0,143,459,6516
2010-10-06,87,5571,209,51,0,142,457,6517
2010-10-05,87,5546,209,51,0,145,457,6495
2010-10-04,90,5551,209,51,0,149,460,6510
2010-10-01,90,5540,209,51,0,151,452,6493
2010-09-30,88,5554,209,52,0,147,459,6509
2010-09-29,89,5539,209,52,0,148,449,6486
2010-09-28,88,5525,209,52,0,145,452,6471
2010-09-27,88,5515,210,52,0,142,451,6458
2010-09-24,88,5526,210,52,0,140,448,6464
2010-09-23,90,5522,211,52,0,137,446,6458
2010-09-22,90,5513,211,52,0,136,445,6447
2010-09-21,90,5506,211,52,0,133,448,6440
2010-09-20,95,5491,210,52,0,131,450,6429
2010-09-17,95,5485,209,52,0,129,448,6418
2010-09-16,95,5490,210,52,0,126,445,6418
2010-09-15,95,5480,210,53,0,124,449,6411
2010-09-14,95,5471,210,53,0,121,448,6398
2010-09-13,95,5452,210,53,0,118,449,6377
2010-09-10,95,5441,211,53,0,116,451,6367
2010-09-09,96,5436,212,53,0,117,449,6363
2010-09-08,95,5435,212,53,0,118,449,6362
2010-09-07,95,5431,212,53,0,123,451,6365
2010-09-06,95,5430,211,53,0,124,447,6360
2010-09-03,96,5418,210,53,0,124,445,6346
2010-09-02,97,5395,211,53,0,123,464,6343
2010-09-01,97,5385,211,53,0,124,442,6312
2010-08-31,100,5369,211,53,0,127,447,6307
2010-08-30,102,5382,211,53,0,127,443,6318
2010-08-27,103,5400,211,54,0,126,442,6336
2010-08-26,101,5382,213,53,0,124,437,6310
2010-08-25,97,5320,213,54,0,123,444,6251
2010-08-24,97,5325,213,54,0,121,441,6251
2010-08-23,445,4987,213,54,0,121,436,6256
2010-08-20,444,4974,214,54,0,120,434,6240
2010-08-19,444,4952,214,54,0,118,440,6222
2010-08-18,442,4944,214,54,0,117,441,6212
2010-08-17,444,4947,214,55,0,115,436,6211
2010-08-13,440,4892,213,55,0,113,437,6150
2010-08-12,436,4882,213,55,0,115,441,6142
2010-08-11,433,4872,213,55,0,116,433,6122
2010-08-10,444,4859,214,55,0,118,431,6121
2010-08-09,432,4828,214,55,0,122,436,6087
2010-08-06,430,4825,214,55,0,122,435,6081
2010-08-05,432,4799,214,55,0,122,429,6051
2010-08-04,427,4781,214,55,0,122,428,6027
2010-08-03,430,4744,214,56,0,122,429,5995
2010-08-02,429,4721,214,56,0,130,429,5979
2010-07-30,433,4748,214,55,0,124,432,6006
2010-07-29,430,4754,214,56,0,124,454,6032
2010-07-28,429,4767,215,56,0,123,454,6044
2010-07-27,433,4744,215,56,0,120,450,6018
2010-07-26,436,4763,215,56,0,118,450,6038
2010-07-23,437,4749,215,57,0,117,427,6002
2010-07-22,437,4695,215,57,0,115,429,5948
2010-07-21,437,4672,214,57,0,114,424,5918
2010-07-20,442,4662,214,57,0,112,418,5905
2010-07-19,443,4622,214,54,0,111,413,5857
2010-07-16,443,4619,214,55,0,110,407,5848
2010-07-15,452,4599,215,55,0,113,403,5837
2010-07-14,443,4579,215,55,0,114,400,5806
2010-07-13,434,4536,214,55,0,117,399,5755
2010-07-12,445,4545,214,55,0,120,398,5777
2010-07-08,447,4538,214,55,0,121,397,5772
2010-07-07,445,4230,215,58,0,122,661,5731
2010-07-06,427,4189,215,58,0,123,655,5667
2010-07-05,432,4209,217,59,0,128,638,5683
2010-07-02,433,4208,213,59,0,129,639,5681
2010-07-01,433,4184,215,59,0,130,637,5658
2010-06-30,434,4232,215,58,0,129,636,5704
2010-06-29,433,4213,214,59,0,129,630,5678
2010-06-28,431,4203,214,59,0,128,621,5656
2010-06-25,431,4252,215,59,0,127,630,5714
2010-06-24,446,4284,215,58,0,125,629,5757
2010-06-23,448,4264,215,58,0,123,637,5745
2010-06-22,451,4245,216,58,0,121,633,5724
2010-06-18,450,4275,216,58,0,120,637,5756
2010-06-17,461,4295,215,56,0,118,616,5761
2010-06-16,467,4294,215,57,0,116,622,5771
2010-06-15,479,4317,216,57,0,114,619,5802
2010-06-14,483,4328,219,57,0,113,609,5809
2010-06-11,487,4317,220,57,0,114,602,5797
2010-06-10,488,4342,220,57,0,117,597,5821
2010-06-09,488,4321,221,57,0,119,608,5814
2010-06-08,490,4306,221,57,0,122,607,5803
2010-06-07,485,4336,221,58,0,125,612,5837
2010-06-04,487,4333,222,58,0,126,607,5833
2010-06-03,483,4330,222,58,0,125,607,5825
2010-06-02,486,4326,222,58,0,125,608,5825
2010-06-01,493,4331,222,58,0,126,611,5841
2010-05-31,482,4330,222,58,0,128,608,5828
2010-05-28,493,4318,222,58,0,127,613,5831
2010-05-27,506,4351,222,58,0,122,614,5873
2010-05-26,499,4359,222,59,0,119,596,5854
2010-05-21,500,4331,222,59,0,116,602,5830
2010-05-20,481,4314,221,59,0,116,610,5801
2010-05-19,486,4301,221,59,0,114,604,5785
2010-05-18,482,4268,220,59,0,112,615,5756
2010-05-17,492,4292,221,59,0,111,615,5790
2010-05-14,493,4329,221,59,0,110,623,5835
2010-05-13,494,4329,221,58,0,112,623,5837
2010-05-12,495,4333,221,58,0,113,625,5845
2010-05-11,506,4309,221,58,0,119,628,5841
2010-05-10,506,4303,222,58,0,120,629,5838
2010-05-07,504,4307,222,58,0,118,627,5836
2010-05-06,496,4313,221,57,0,118,642,5847
2010-05-05,499,4323,221,57,0,119,637,5856
2010-05-04,495,4327,221,57,0,120,636,5856
2010-05-03,498,4311,221,57,0,124,631,5842
2010-04-30,481,4314,221,58,0,122,633,5829
2010-04-29,483,4297,221,56,0,123,641,5821
2010-04-28,481,4308,222,56,0,121,636,5824
2010-04-27,481,4277,221,57,0,119,628,5783
2010-04-26,483,4292,227,57,0,115,627,5801
2010-04-23,482,4294,228,57,0,116,633,5810
2010-04-22,483,4299,228,58,0,116,626,5810
2010-04-21,484,4297,228,57,0,116,613,5795
2010-04-20,477,4263,228,58,0,115,620,5761
2010-04-19,473,4252,227,58,0,114,619,5743
2010-04-16,482,4235,227,58,0,112,635,5749
2010-04-15,484,4196,227,58,0,112,626,5703
2010-04-14,484,4186,227,58,0,116,627,5698
2010-04-13,466,4210,227,58,0,119,620,5700
2010-04-12,465,4170,227,58,0,123,638,5681
2010-04-09,467,4145,227,58,0,125,644,5666
2010-04-08,462,4115,227,58,0,125,645,5632
2010-04-07,447,4099,227,58,0,127,643,5601
2010-04-06,448,4070,227,58,0,127,643,5573
2010-04-05,441,4047,227,59,0,131,638,5543
2010-03-31,442,4071,227,59,0,126,646,5571
2010-03-30,449,4085,227,59,0,133,643,5596
2010-03-29,454,4053,228,59,0,131,643,5568
2010-03-26,453,4065,228,59,0,130,637,5572
2010-03-25,448,4054,228,59,0,128,637,5554
2010-03-23,447,4059,228,59,0,127,635,5555
2010-03-22,449,4060,228,59,0,125,633,5554
2010-03-19,449,4063,229,59,0,124,625,5549
2010-03-18,449,4053,229,59,0,123,626,5539
2010-03-17,441,4050,230,60,0,122,625,5528
2010-03-16,435,4020,230,59,0,121,624,5489
2010-03-15,430,3971,230,60,0,119,624,5434
2010-03-12,431,3967,230,60,0,119,618,5425
2010-03-11,429,3965,230,60,0,122,613,5419
2010-03-10,423,3969,230,60,0,124,614,5420
2010-03-09,423,3961,230,60,0,128,609,5411
2010-03-08,421,3952,230,60,0,132,597,5392
2010-03-05,419,3947,230,60,0,134,592,5382
2010-03-04,416,3945,230,60,0,133,592,5376
2010-03-03,415,3934,230,60,0,134,600,5373
2010-03-02,416,3928,230,60,0,135,599,5368
2010-03-01,412,3914,230,60,0,139,598,5353
2010-02-26,407,3906,231,60,0,138,604,5346
2010-02-25,407,3896,229,61,0,138,606,5337
2010-02-24,405,3911,229,61,0,137,596,5339
2010-02-23,405,3908,229,61,0,135,593,5331
2010-02-22,399,3921,229,61,0,133,595,5338
2010-02-19,400,3910,229,61,0,132,595,5327
2010-02-18,398,3909,229,61,0,130,595,5322
2010-02-17,399,3901,228,61,0,129,590,5308
2010-02-16,407,3925,228,61,0,127,597,5345
2010-02-15,409,3916,228,61,0,118,598,5330
2010-02-12,407,3913,228,61,0,121,598,5328
2010-02-11,402,3899,228,61,0,123,590,5303
2010-02-10,389,3898,228,61,0,123,591,5290
2010-02-09,389,3899,229,61,0,130,594,5302
2010-02-08,391,3912,229,62,0,133,605,5332
2010-02-05,387,3898,229,62,0,131,601,5308
2010-02-04,382,3877,229,62,0,129,598,5277
2010-02-03,382,3878,229,62,0,129,596,5276
2010-02-02,370,3888,229,62,0,129,599,5277
2010-02-01,369,3856,229,62,0,131,595,5242
2010-01-29,359,3883,229,62,0,129,606,5268
2010-01-28,354,3865,229,62,0,127,603,5240
2010-01-27,356,3897,229,63,0,125,602,5272
2010-01-26,349,3905,229,63,0,121,605,5272
2010-01-25,344,3923,229,63,0,119,602,5280
2010-01-22,343,3924,229,63,0,116,601,5276
2010-01-21,336,3954,229,63,0,113,596,5291
2010-01-20,334,3944,229,63,0,111,597,5278
2010-01-19,332,3956,229,63,0,110,595,5285
2010-01-18,330,3913,229,63,0,107,596,5238
2010-01-15,331,3954,227,63,0,104,596,5275
2010-01-14,333,3960,227,63,0,105,602,5290
2010-01-13,332,3944,228,63,0,106,600,5273
2010-01-12,332,3956,228,63,0,109,604,5292
2010-01-11,336,3942,228,63,0,109,601,5279
2010-01-08,345,3938,228,63,0,108,603,5285
2010-01-07,346,3970,228,63,0,106,602,5315
2010-01-06,344,3967,228,63,0,104,605,5311
2010-01-05,347,3963,228,63,0,104,609,5314
2010-01-04,348,3982,229,63,0,105,614,5341
2009-12-31,348,3975,229,63,0,105,576,5296
2009-12-30,348,3976,229,63,0,106,570,5292
2009-12-29,351,3973,229,63,0,103,569,5288
2009-12-28,351,3954,229,64,0,103,572,5273
2009-12-24,351,3955,229,64,0,103,573,5275
2009-12-23,350,3958,230,64,0,102,573,5277
2009-12-22,350,3952,229,64,0,102,569,5266
2009-12-21,349,3926,229,64,0,101,569,5238
2009-12-18,348,3922,230,64,0,100,568,5232
2009-12-17,347,3920,229,64,0,99,583,5242
2009-12-16,350,3920,229,64,0,98,584,5245
2009-12-15,348,3908,230,64,0,96,582,5228
2009-12-14,345,3884,231,64,0,96,581,5201
2009-12-11,344,3892,232,64,0,95,575,5202
2009-12-10,344,3885,232,64,0,97,582,5204
2009-12-09,339,3874,232,64,0,98,573,5180
2009-12-07,338,3871,231,64,0,101,588,5193
2009-12-04,338,3873,230,64,0,101,593,5199
2009-12-03,337,3880,230,63,0,100,586,5196
2009-12-02,340,3863,231,63,0,100,602,5199
2009-12-01,341,3908,231,63,0,102,601,5246
2009-11-30,336,3921,231,63,0,104,602,5257
2009-11-27,335,3879,230,64,0,105,589,5202
2009-11-26,320,3878,230,64,0,102,582,5176
2009-11-25,325,3876,230,64,0,103,588,5186
2009-11-24,325,3903,230,64,0,101,593,5216
2009-11-23,324,3933,230,64,0,100,591,5242
2009-11-20,322,3925,230,64,0,99,592,5232
2009-11-19,325,3939,229,64,0,98,586,5241
2009-11-18,315,3905,229,64,0,97,587,5197
2009-11-17,310,3864,229,64,0,95,585,5147
2009-11-16,309,3860,229,64,0,96,581,5139
2009-11-13,312,3853,230,64,0,94,580,5133
2009-11-12,310,3847,230,64,0,95,578,5124
2009-11-11,309,3747,229,64,0,97,579,5025
2009-11-10,307,3746,229,64,0,100,576,5022
2009-11-09,303,3785,229,64,0,103,572,5056
2009-11-05,300,3834,228,64,0,102,577,5105
2009-11-04,306,3880,228,64,0,102,576,5156
2009-11-03,305,3892,228,64,0,103,576,5168
2009-11-02,320,3898,228,64,0,106,575,5191
2009-10-30,318,3914,228,63,0,106,584,5213
2009-10-29,320,3916,228,64,0,107,587,5222
2009-10-28,318,3915,228,64,0,107,587,5219
2009-10-27,314,3923,229,64,0,105,591,5226
2009-10-26,316,3906,229,64,0,104,586,5205
2009-10-23,314,3935,229,64,0,102,598,5242
2009-10-22,310,3944,229,64,0,102,596,5245
2009-10-21,309,3931,229,64,0,100,596,5229
2009-10-20,303,3929,229,64,0,99,590,5214
2009-10-19,302,3906,229,64,0,98,566,5165
2009-10-16,307,3913,229,64,0,97,574,5184
2009-10-15,310,3880,229,64,0,99,575,5157
2009-10-14,311,3862,230,64,0,102,561,5130
2009-10-13,321,3877,230,64,0,105,555,5152
2009-10-09,320,3880,228,64,0,105,555,5152
2009-10-08,318,3874,228,64,0,105,545,5134
2009-10-07,305,3884,228,64,0,105,541,5127
2009-10-06,306,3894,228,64,0,105,545,5142
2009-10-05,304,3894,228,65,0,108,546,5145
2009-10-02,301,3882,228,65,0,108,555,5139
2009-10-01,311,3897,229,65,0,108,551,5161
2009-09-30,310,3928,229,64,0,107,550,5188
2009-09-29,312,3941,226,65,0,105,567,5216
2009-09-28,315,3951,226,65,0,103,566,5226
2009-09-25,315,3964,223,65,0,102,572,5241
2009-09-24,313,3975,224,65,0,101,578,5256
2009-09-23,323,3977,223,65,0,100,576,5264
2009-09-22,317,3992,223,65,0,99,564,5260
2009-09-21,316,4025,224,65,0,97,576,5303
2009-09-18,322,4020,224,65,0,95,581,5307
2009-09-17,307,4015,221,65,0,94,587,5289
2009-09-16,304,4010,221,65,0,92,582,5274
2009-09-15,314,4020,221,65,0,90,580,5290
2009-09-14,313,4027,221,66,0,88,588,5303
2009-09-11,314,4018,221,66,0,86,590,5295
2009-09-10,312,4032,221,66,0,87,589,5307
2009-09-09,313,4044,221,66,0,88,585,5317
2009-09-08,312,4046,221,66,0,91,600,5336
2009-09-07,312,4066,221,66,0,92,614,5371
2009-09-04,314,4069,221,66,0,92,614,5376
2009-09-03,316,4093,221,66,0,91,614,5401
2009-09-02,296,4125,222,66,0,92,614,5415
2009-09-01,294,4158,222,66,0,93,603,5436
2009-08-31,289,4156,222,66,0,95,606,5434
2009-08-28,290,4161,221,66,0,95,612,5445
2009-08-27,281,4138,221,67,0,94,621,5422
2009-08-26,290,4169,221,67,0,94,611,5452
2009-08-25,288,4170,221,67,0,93,609,5448
2009-08-24,289,4167,221,67,0,93,612,5449
2009-08-21,288,4199,221,67,0,92,618,5485
2009-08-20,288,4204,221,63,0,90,612,5478
2009-08-19,288,4218,221,64,0,88,614,5493
2009-08-18,282,4194,221,64,0,86,621,5468
2009-08-14,282,4183,222,64,0,85,620,5456
2009-08-13,283,4197,222,64,0,87,601,5454
2009-08-12,282,4226,222,64,0,89,592,5475
2009-08-11,281,4269,221,64,0,92,602,5529
2009-08-10,280,4270,221,64,0,94,601,5530
2009-08-07,280,4299,221,64,0,93,596,5553
2009-08-06,281,4295,221,64,0,93,607,5561
2009-08-05,281,4281,221,65,0,94,607,5549
2009-08-04,281,4294,221,65,0,94,608,5563
2009-08-03,282,4274,221,65,0,96,605,5543
2009-07-31,281,4338,221,68,0,96,617,5621
2009-07-30,281,4370,221,65,0,95,651,5683
2009-07-29,282,4368,221,66,0,94,629,5660
2009-07-28,283,4367,221,66,0,92,628,5657
2009-07-27,284,4362,221,66,0,90,633,5656
2009-07-24,283,4372,221,69,0,90,638,5673
2009-07-23,284,4377,221,69,0,88,637,5676
2009-07-22,297,4387,221,66,0,87,640,5698
2009-07-21,293,4410,221,66,0,87,642,5719
2009-07-20,291,4444,221,66,0,85,642,5749
2009-07-17,291,4463,221,67,0,84,645,5771
2009-07-16,302,4456,221,67,0,86,638,5770
2009-07-15,300,4424,221,67,0,87,637,5736
2009-07-14,299,4430,220,68,0,90,643,5750
2009-07-13,301,4436,220,67,0,91,637,5752
2009-07-08,300,4512,220,67,0,91,645,5835
2009-07-07,300,4516,222,67,0,93,639,5837
2009-07-06,299,4529,222,67,0,95,640,5852
2009-07-03,299,4544,223,68,0,97,633,5864
2009-07-02,299,4540,222,68,0,96,626,5851
2009-07-01,298,4521,220,68,0,96,619,5822
2009-06-30,298,4520,220,71,0,96,620,5825
2009-06-29,298,4561,220,69,0,93,627,5868
2009-06-26,295,4651,220,69,0,94,631,5960
2009-06-25,285,4677,220,69,0,94,625,5970
2009-06-24,285,4683,221,69,0,94,625,5977
2009-06-23,290,4698,221,69,0,93,623,5994
2009-06-22,290,4699,221,69,0,92,624,5995
2009-06-19,279,4720,221,69,0,91,625,6005
2009-06-18,293,4714,222,70,0,89,623,6011
2009-06-17,292,4732,222,70,0,88,620,6024
2009-06-16,295,4738,222,70,0,87,616,6028
2009-06-12,293,4743,223,70,0,86,621,6036
2009-06-11,304,4725,223,70,0,87,622,6031
2009-06-10,305,4753,223,71,0,88,621,6061
2009-06-09,302,4737,222,71,0,88,623,6043
2009-06-08,301,4787,222,71,0,90,616,6087
2009-06-05,305,4785,221,71,0,90,617,6089
2009-06-04,305,4782,222,71,0,89,618,6087
2009-06-03,303,4762,222,71,0,89,619,6066
2009-06-02,303,4794,220,72,0,90,615,6094
2009-06-01,304,4813,220,71,0,92,609,6109
2009-05-29,303,4787,221,74,0,91,610,6086
2009-05-28,301,4796,222,72,0,91,611,6093
2009-05-27,302,4805,222,72,0,90,611,6102
2009-05-26,307,4766,222,72,0,87,601,6055
2009-05-22,305,4799,222,72,0,87,609,6094
2009-05-21,291,4773,222,72,0,86,613,6057
2009-05-20,296,4774,222,72,0,86,611,6061
2009-05-19,293,4787,222,73,0,86,609,6070
2009-05-18,294,4791,222,73,0,85,611,6076
2009-05-15,293,4791,222,73,0,85,622,6086
2009-05-14,299,4786,222,73,0,88,629,6097
2009-05-13,299,4795,222,73,0,88,629,6106
2009-05-12,308,4805,222,73,0,92,624,6124
2009-05-11,298,4742,222,73,0,95,617,6047
2009-05-08,290,4745,222,74,0,95,616,6042
2009-05-07,275,4752,222,74,0,95,603,6021
2009-05-06,275,4749,222,74,0,96,598,6014
2009-05-05,259,4728,222,74,0,99,598,5980
2009-05-04,256,4698,222,74,0,98,596,5944
2009-04-30,241,4691,222,75,0,98,587,5914
2009-04-29,243,4692,221,74,0,100,588,5918
2009-04-28,241,4672,221,74,0,98,596,5902
2009-04-27,241,4682,228,74,0,97,594,5916
2009-04-24,242,4685,229,75,0,97,599,5927
2009-04-23,242,4662,229,75,0,96,597,5901
2009-04-22,234,4625,229,75,0,95,595,5853
2009-04-21,232,4639,229,75,0,94,596,5865
2009-04-20,220,4665,230,77,0,93,561,5846
2009-04-17,223,4704,230,77,0,93,556,5883
2009-04-16,190,4718,230,77,0,92,556,5863
2009-04-15,184,4734,230,78,0,90,551,5867
2009-04-14,185,4729,229,78,0,89,551,5861
2009-04-13,186,4774,229,78,0,86,561,5914
2009-04-08,188,4818,229,78,0,88,561,5962
2009-04-07,197,4852,229,78,0,90,564,6010
2009-04-06,188,4854,229,78,0,93,545,5987
2009-04-03,191,4851,230,78,0,92,557,5999
2009-04-01,183,4847,230,78,0,93,564,5995
2009-03-31,183,4819,230,76,0,96,592,5996
2009-03-30,182,4865,229,78,0,95,565,6014
2009-03-27,175,4892,229,78,0,96,551,6021
2009-03-26,175,4895,229,78,0,95,564,6036
2009-03-25,181,4891,227,76,0,94,564,6033
2009-03-23,162,4908,228,76,0,92,561,6027
2009-03-20,163,4937,228,75,0,93,566,6062
2009-03-19,157,4896,228,75,0,91,568,6015
2009-03-18,155,4925,228,75,0,92,568,6043
2009-03-17,156,4938,228,75,0,92,569,6058
2009-03-16,156,4957,226,75,0,91,568,6073
2009-03-13,156,4966,226,75,0,91,566,6080
2009-03-12,157,4978,227,75,0,94,562,6093
2009-03-11,157,4962,227,75,0,95,561,6077
2009-03-10,159,4949,227,75,0,99,558,6067
2009-03-09,161,4952,227,75,0,103,553,6071
2009-03-06,162,4974,227,76,0,103,558,6100
2009-03-05,162,4940,227,76,0,103,553,6061
2009-03-04,164,4911,227,76,0,104,547,6029
2009-03-03,161,4959,227,76,0,107,550,6080
2009-03-02,170,4982,227,76,0,109,539,6103
2009-02-27,162,4981,227,77,0,108,570,6125
2009-02-26,154,4968,227,77,0,109,552,6087
2009-02-25,154,4959,227,77,0,108,549,6074
2009-02-24,155,4948,224,77,0,108,549,6061
2009-02-23,146,4975,225,77,0,106,550,6079
2009-02-20,145,4985,225,77,0,106,552,6090
2009-02-19,149,4956,225,77,0,103,553,6063
2009-02-18,150,4951,225,77,0,102,550,6055
2009-02-17,149,4939,225,77,0,101,550,6041
2009-02-16,144,4904,224,77,0,101,542,5992
2009-02-13,145,4906,225,77,0,99,540,5992
2009-02-12,145,4887,225,77,0,101,539,5974
2009-02-11,146,4871,225,77,0,102,536,5957
2009-02-10,147,4806,225,77,0,104,536,5895
2009-02-09,147,4784,225,77,0,106,537,5876
2009-02-06,150,4780,225,77,0,105,541,5878
2009-02-05,150,4775,225,77,0,104,541,5872
2009-02-04,149,4765,224,77,0,104,537,5856
2009-02-03,149,4752,224,78,0,105,540,5848
2009-02-02,149,4798,224,78,0,105,537,5891
2009-01-30,153,4786,224,78,0,103,545,5889
2009-01-29,152,4802,223,78,0,100,536,5891
2009-01-28,151,4807,223,78,0,98,528,5885
2009-01-27,151,4794,223,77,0,96,535,5876
2009-01-26,152,4799,224,77,0,94,530,5876
2009-01-23,151,4789,224,77,0,92,532,5865
2009-01-22,152,4789,224,76,0,89,525,5855
2009-01-21,152,4786,224,76,0,87,525,5850
2009-01-20,152,4788,224,76,0,84,527,5851
2009-01-19,142,4775,225,75,0,83,529,5829
2009-01-16,142,4766,225,76,0,80,527,5816
2009-01-15,143,4798,225,76,0,79,508,5829
2009-01-14,141,4812,225,76,0,81,506,5841
2009-01-13,142,4807,225,76,0,81,505,5836
2009-01-12,142,4796,225,76,0,83,509,5831
2009-01-09,143,4799,223,76,0,81,514,5836
2009-01-08,143,4798,223,76,0,79,508,5827
2009-01-07,143,4786,224,76,0,79,512,5820
2009-01-06,143,4764,224,76,0,78,512,5797
2009-01-05,140,4764,224,76,0,78,516,5798
2009-01-02,142,4817,223,76,0,79,515,5852
2008-12-31,145,4817,224,76,0,77,518,5857
2008-12-30,150,4824,223,76,0,77,516,5866
2008-12-29,150,4839,224,76,0,76,517,5882
2008-12-26,155,4858,224,76,0,75,520,5908
2008-12-24,155,4860,224,76,0,75,539,5929
2008-12-23,156,4866,224,76,0,75,538,5935
2008-12-22,151,4880,224,76,0,74,537,5942
2008-12-19,151,4879,225,76,0,73,547,5951
2008-12-18,152,4877,226,75,0,72,540,5942
2008-12-17,152,4873,226,76,0,71,536,5934
2008-12-16,152,4864,226,75,0,70,538,5925
2008-12-15,153,4900,226,75,0,70,527,5951
2008-12-12,153,4909,227,75,0,70,527,5961
2008-12-11,155,4911,227,75,0,71,529,5968
2008-12-10,155,4918,228,75,0,72,529,5977
2008-12-09,152,4934,228,75,0,73,527,5989
2008-12-05,158,4958,228,76,0,74,530,6024
2008-12-04,158,4975,227,76,0,73,532,6041
2008-12-03,158,4966,227,75,0,74,527,6027
2008-12-02,158,4964,227,75,0,76,521,6021
2008-12-01,160,4952,227,76,0,76,515,6006
2008-11-28,162,4948,228,76,0,76,513,6003
2008-11-27,169,4950,226,76,0,76,516,6013
2008-11-26,169,4957,226,76,0,76,516,6020
2008-11-25,169,4977,226,76,0,76,517,6041
2008-11-24,168,4993,226,75,0,75,510,6047
2008-11-21,168,5014,226,75,0,74,515,6072
2008-11-20,170,4991,226,80,0,73,507,6047
2008-11-19,170,4979,226,80,0,73,508,6036
2008-11-18,170,4991,226,80,0,73,510,6050
2008-11-17,170,4990,226,80,0,71,515,6052
2008-11-14,173,5019,226,80,0,71,506,6075
2008-11-13,172,5068,226,80,0,73,515,6134
2008-11-12,172,5077,226,84,0,75,514,6148
2008-11-11,171,5080,226,84,0,77,503,6141
2008-11-10,171,5076,226,84,0,79,498,6134
2008-11-07,171,5124,226,84,0,78,498,6181
2008-11-05,170,5113,226,84,0,78,498,6169
2008-11-04,170,5114,225,84,0,81,496,6170
2008-11-03,169,5089,226,84,0,83,505,6156
2008-10-31,168,5109,225,84,0,82,509,6177
2008-10-30,178,5130,225,84,0,83,496,6196
2008-10-29,178,5127,222,85,0,82,497,6191
2008-10-28,178,5136,222,85,0,82,506,6209
2008-10-27,181,5139,222,85,0,81,503,6211
2008-10-24,182,5158,223,85,0,80,506,6234
2008-10-23,188,5167,223,85,0,80,509,6252
2008-10-22,186,5167,223,84,0,80,507,6247
2008-10-21,185,5136,223,84,0,79,503,6210
2008-10-20,186,5119,223,84,0,78,506,6196
2008-10-17,185,5117,223,85,0,77,509,6196
2008-10-16,194,5122,223,83,0,80,507,6209
2008-10-15,193,5131,222,84,0,83,506,6219
2008-10-14,192,5146,223,84,0,85,504,6234
2008-10-10,191,5115,222,84,0,88,493,6193
2008-10-09,190,5115,223,84,0,88,514,6214
2008-10-08,189,5117,223,84,0,90,512,6215
2008-10-07,189,5110,223,84,0,91,519,6216
2008-10-06,189,5110,223,84,0,92,519,6217
2008-10-03,189,5088,223,84,0,94,524,6202
2008-10-02,187,5088,222,84,0,92,522,6195
2008-10-01,186,5082,222,84,0,91,520,6185
2008-09-30,187,5020,222,84,0,87,520,6120
2008-09-29,194,5104,224,84,0,88,513,6207
2008-09-26,194,5048,224,84,0,87,516,6153
2008-09-25,195,5042,224,84,0,85,520,6150
2008-09-24,195,5047,224,86,0,85,522,6159
2008-09-23,195,5035,224,85,0,84,524,6147
2008-09-22,196,5040,224,86,0,83,522,6151
2008-09-19,196,5017,225,86,0,81,524,6129
2008-09-18,195,5035,225,86,0,79,522,6142
2008-09-17,197,5020,225,86,0,78,515,6121
2008-09-16,191,5006,225,86,0,76,516,6100
2008-09-15,191,5002,225,86,0,75,516,6095
2008-09-12,198,4989,225,86,0,74,516,6088
2008-09-11,198,4985,225,86,0,76,514,6084
2008-09-10,197,5004,226,86,0,76,514,6103
2008-09-09,199,4976,225,86,0,78,509,6073
2008-09-08,191,5008,225,86,0,79,510,6099
2008-09-05,194,5027,225,86,0,79,506,6117
2008-09-04,191,5002,225,85,0,79,516,6098
2008-09-03,191,5012,225,85,0,79,515,6107
2008-09-02,198,5002,225,85,0,82,513,6105
2008-09-01,200,5008,223,86,0,83,512,6112
2008-08-29,199,4996,223,85,0,81,518,6102
2008-08-28,198,5013,223,85,0,81,509,6109
2008-08-27,197,5026,223,85,0,81,511,6123
2008-08-26,196,5029,223,85,0,80,500,6113
2008-08-25,196,5021,223,85,0,78,504,6107
2008-08-22,196,5026,223,85,0,77,501,6108
2008-08-21,196,5025,223,85,0,76,502,6107
2008-08-20,197,5018,223,84,0,76,489,6087
2008-08-19,200,5024,223,84,0,75,483,6089
2008-08-15,197,5024,223,85,0,75,492,6096
2008-08-14,192,4985,222,85,0,76,500,6060
2008-08-13,192,4941,222,85,0,78,493,6011
2008-08-12,193,4929,222,85,0,81,488,5998
2008-08-11,193,4914,222,85,0,83,487,5984
2008-08-08,202,4889,222,85,0,82,503,5983
2008-08-07,203,4898,222,85,0,81,508,5997
2008-08-06,203,4857,222,85,0,81,505,5953
2008-08-05,213,4855,222,85,0,83,503,5961
2008-08-04,212,4873,222,85,0,84,497,5973
2008-08-01,213,4883,222,85,0,84,493,5980
2008-07-31,210,4878,222,84,0,82,498,5974
2008-07-30,213,4908,222,85,0,82,494,6004
2008-07-29,213,4918,222,85,0,82,490,6010
2008-07-28,213,4916,222,85,0,80,489,6005
2008-07-25,213,4919,221,85,0,79,485,6002
2008-07-24,213,4902,221,85,0,77,489,5987
2008-07-23,212,4907,221,85,0,76,483,5984
2008-07-22,217,4902,221,85,0,75,482,5982
2008-07-21,218,4889,221,85,0,74,490,5977
2008-07-18,218,4900,221,85,0,74,490,5988
2008-07-17,219,4883,221,86,0,72,489,5970
2008-07-16,219,4836,221,86,0,72,488,5922
2008-07-15,218,4828,214,86,0,71,492,5909
2008-07-14,217,4832,214,86,0,70,492,5911
2008-07-11,216,4799,214,86,0,70,496,5881
2008-07-10,216,4788,214,86,0,71,493,5868
2008-07-08,217,4791,214,86,0,74,487,5869
2008-07-07,216,4802,214,85,0,76,477,5870
2008-07-04,216,4791,214,86,0,76,483,5866
2008-07-03,215,4793,214,86,0,76,479,5863
2008-07-02,208,4776,214,86,0,77,481,5842
2008-07-01,208,4752,214,86,0,80,492,5832
2008-06-30,217,4719,214,86,0,80,511,5827
2008-06-27,214,4787,212,87,0,79,516,5895
2008-06-26,203,4756,212,86,0,78,500,5835
2008-06-25,204,4748,212,85,0,77,500,5826
2008-06-24,204,4753,211,85,0,76,496,5825
2008-06-23,203,4760,211,85,0,75,498,5832
2008-06-20,203,4779,211,87,0,74,494,5848
2008-06-19,203,4774,211,86,0,73,492,5839
2008-06-18,186,4767,212,78,0,72,500,5815
2008-06-17,185,4773,212,79,0,70,503,5822
2008-06-13,179,4763,213,79,0,70,502,5806
2008-06-12,179,4728,213,79,0,71,502,5772
2008-06-11,177,4708,213,79,0,72,498,5747
2008-06-10,176,4694,212,79,0,74,498,5733
2008-06-09,176,4703,212,78,0,78,496,5743
2008-06-06,175,4704,212,78,0,78,493,5740
2008-06-05,173,4694,212,78,0,77,497,5731
2008-06-04,163,4683,212,78,0,77,495,5708
2008-06-03,165,4697,211,77,0,79,496,5725
2008-06-02,163,4710,211,77,0,81,495,5737
2008-05-30,150,4706,211,78,0,80,486,5711
2008-05-29,149,4695,212,76,0,80,494,5706
2008-05-28,148,4666,211,75,0,78,503,5681
2008-05-27,149,4673,211,75,0,77,515,5700
2008-05-26,147,4655,211,73,0,77,513,5676
2008-05-23,147,4646,211,73,0,75,514,5666
2008-05-22,150,4639,210,73,0,73,509,5654
2008-05-21,149,4627,210,73,0,73,494,5626
2008-05-20,149,4623,209,72,0,72,494,5619
2008-05-19,149,4646,209,71,0,71,494,5640
2008-05-16,153,4673,207,71,0,70,495,5669
2008-05-15,154,4661,201,71,0,70,491,5648
2008-05-14,154,4667,201,71,0,72,498,5663
2008-05-13,154,4641,201,71,0,74,485,5626
2008-05-12,155,4631,200,71,0,75,481,5613
2008-05-09,154,4648,200,70,0,79,479,5630
2008-05-08,150,4643,200,71,0,78,479,5621
2008-05-07,150,4632,200,69,0,79,480,5610
2008-05-06,142,4653,200,70,0,81,479,5625
2008-05-05,142,4673,201,69,0,83,478,5646
2008-05-02,143,4701,201,69,0,84,467,5665
2008-04-30,142,4698,201,69,0,81,466,5657
2008-04-29,142,4702,201,69,0,82,460,5656
2008-04-28,142,4667,201,69,0,81,459,5619
2008-04-25,141,4639,167,70,0,80,454,5551
2008-04-24,136,4512,167,69,0,78,577,5539
2008-04-23,141,4486,167,69,0,78,576,5517
2008-04-22,141,4512,167,69,0,77,573,5539
2008-04-21,145,4498,167,69,0,76,575,5530
2008-04-18,146,4482,171,68,0,75,583,5525
2008-04-17,143,4472,170,68,0,75,581,5509
2008-04-16,144,4450,171,67,0,74,575,5481
2008-04-15,140,4465,170,67,0,72,579,5493
2008-04-14,140,4432,170,66,0,72,574,5454
2008-04-11,140,4443,170,66,0,71,577,5467
2008-04-10,140,4427,168,66,0,73,576,5450
2008-04-09,140,4408,168,65,0,74,589,5444
2008-04-08,138,4406,168,65,0,77,578,5432
2008-04-07,137,4365,168,65,0,79,577,5391
2008-04-04,136,4361,167,65,0,80,572,5381
2008-04-03,136,4328,167,65,0,80,568,5344
2008-04-01,139,4356,166,65,0,81,574,5381
2008-03-31,139,4344,167,65,0,82,578,5375
2008-03-28,133,4393,164,65,0,81,576,5412
2008-03-27,133,4391,164,65,0,80,572,5405
2008-03-26,134,4404,164,65,0,78,580,5425
2008-03-25,133,4371,163,65,0,74,581,5387
2008-03-19,136,4372,162,65,0,73,569,5377
2008-03-18,137,4388,161,65,0,73,564,5388
2008-03-17,137,4406,161,65,0,72,563,5404
2008-03-14,135,4412,161,65,0,72,561,5406
2008-03-13,135,4419,161,65,0,73,561,5414
2008-03-12,135,4406,162,65,0,75,556,5399
2008-03-11,137,4411,156,65,0,78,554,5401
2008-03-10,137,4422,156,65,0,82,555,5417
2008-03-07,135,4419,156,64,0,82,555,5411
2008-03-06,135,4411,156,62,0,81,555,5400
2008-03-05,135,4414,156,64,0,82,547,5398
2008-03-04,135,4414,156,64,0,85,539,5393
2008-03-03,135,4419,156,64,0,88,556,5418
2008-02-29,134,4423,156,64,0,88,559,5424
2008-02-28,138,4434,154,63,0,87,556,5432
2008-02-27,142,4456,154,64,0,86,568,5470
2008-02-26,137,4497,154,64,0,85,564,5501
2008-02-25,137,4473,154,64,0,84,567,5479
2008-02-22,138,4483,154,63,0,82,568,5488
2008-02-21,139,4477,154,63,0,81,568,5482
2008-02-20,138,4473,154,62,0,79,578,5484
2008-02-19,136,4477,154,60,0,79,574,5480
2008-02-18,138,4486,154,60,0,79,578,5495
2008-02-15,138,4490,154,59,0,78,578,5497
2008-02-14,146,4488,154,59,0,80,576,5503
2008-02-13,141,4471,154,59,0,81,581,5487
2008-02-12,142,4469,154,59,0,83,581,5488
2008-02-11,142,4445,154,59,0,86,579,5465
2008-02-08,142,4448,154,59,0,86,571,5460
2008-02-07,146,4452,154,58,0,84,571,5465
2008-02-06,140,4473,152,58,0,84,565,5472
2008-02-05,138,4488,152,56,0,86,560,5480
2008-02-04,139,4493,149,55,0,87,559,5482
2008-02-01,140,4506,149,55,0,85,562,5497
2008-01-31,139,4482,149,55,0,85,561,5471
2008-01-30,139,4449,149,54,0,82,555,5428
2008-01-29,138,4443,149,53,0,79,554,5416
2008-01-28,138,4448,148,52,0,77,559,5422
2008-01-25,150,4453,148,52,0,75,558,5436
2008-01-24,148,4453,148,52,0,73,560,5434
2008-01-23,149,4431,147,52,0,71,554,5404
2008-01-22,151,4459,147,52,0,70,558,5437
2008-01-21,150,4425,147,52,0,67,558,5399
2008-01-18,150,4425,147,51,0,65,548,5386
2008-01-17,150,4422,147,51,0,63,542,5375
2008-01-16,149,4408,147,51,0,60,540,5355
2008-01-15,149,4412,147,51,0,59,543,5361
2008-01-14,147,4398,147,51,0,58,542,5343
2008-01-11,148,4370,147,51,0,56,547,5319
2008-01-10,148,4382,147,51,0,56,544,5328
2008-01-09,142,4343,146,51,0,56,535,5273
2008-01-08,142,4359,146,51,0,56,535,5289
2008-01-07,140,4349,144,51,0,57,539,5280
2008-01-04,140,4329,143,51,0,56,540,5259
2008-01-03,141,4326,143,51,0,56,534,5251
2008-01-02,141,4328,144,51,0,56,534,5254
2007-12-28,139,4278,144,51,0,55,522,5189
2007-12-27,139,4340,139,50,0,54,548,5270
2007-12-26,138,4304,138,49,0,55,548,5232
2007-12-21,141,4303,138,49,0,54,543,5228
2007-12-20,141,4308,139,48,0,53,545,5234
2007-12-19,141,4285,139,48,0,52,543,5208
2007-12-18,140,4271,139,48,0,52,544,5194
2007-12-17,140,4264,140,48,0,52,544,5188
2007-12-14,140,4269,141,48,0,52,541,5191
2007-12-13,140,4260,140,47,0,53,554,5194
2007-12-12,139,4251,140,47,0,54,544,5175
2007-12-11,144,4192,139,47,0,55,544,5121
2007-12-10,146,4188,138,47,0,57,543,5119
2007-12-07,146,4192,137,47,0,57,542,5121
2007-12-06,146,4182,137,47,0,57,542,5111
2007-12-05,141,4187,137,47,0,57,543,5112
2007-12-04,141,4174,136,47,0,58,539,5095
2007-12-03,143,4161,136,47,0,60,539,5086
2007-11-30,137,4181,135,47,0,59,527,5086
2007-11-29,143,4163,135,47,0,60,535,5083
2007-11-28,143,4196,135,47,0,59,535,5115
2007-11-27,143,4190,135,47,0,58,532,5105
2007-11-26,144,4202,135,47,0,58,532,5118
2007-11-23,145,4193,135,47,0,58,528,5106
2007-11-22,145,4187,133,47,0,57,526,5095
2007-11-21,145,4181,134,47,0,57,524,5088
2007-11-20,149,4177,134,47,0,57,522,5086
2007-11-19,149,4165,134,46,0,57,522,5073
2007-11-16,150,4136,134,46,0,57,524,5047
2007-11-15,141,4112,133,46,0,60,524,5016
2007-11-14,142,4149,133,46,0,58,523,5051
2007-11-13,142,4151,133,46,0,62,522,5056
2007-11-12,142,4136,133,45,0,65,524,5045
2007-11-09,143,4143,133,45,0,66,524,5054
2007-11-08,142,4151,132,46,0,66,519,5056
2007-11-07,142,4125,131,46,0,66,525,5035
2007-11-05,142,4125,131,46,0,69,527,5040
2007-11-02,145,4124,130,46,0,70,525,5040
2007-11-01,145,4119,131,46,0,69,527,5037
2007-10-31,145,4101,127,46,0,69,527,5015
2007-10-30,147,4096,127,45,0,68,529,5012
2007-10-29,143,4090,127,45,0,67,527,4999
2007-10-26,141,4081,127,46,0,66,528,4989
2007-10-25,141,4074,127,45,0,65,526,4978
2007-10-24,141,4069,127,45,0,65,523,4970
2007-10-23,141,4071,127,45,0,65,523,4972
2007-10-22,142,4067,127,45,0,64,519,4964
2007-10-19,142,4066,127,45,0,62,519,4961
2007-10-18,142,4076,127,45,0,61,517,4968
2007-10-17,142,4079,127,45,0,60,521,4974
2007-10-16,142,4074,127,45,0,57,530,4975
2007-10-12,140,4083,127,45,0,56,535,4986
2007-10-11,140,4062,126,45,0,56,535,4964
2007-10-10,140,4042,126,45,0,56,533,4942
2007-10-09,141,4027,126,45,0,59,533,4931
2007-10-08,141,4051,126,45,0,61,533,4957
2007-10-05,141,4055,126,44,0,60,532,4958
2007-10-04,141,4060,126,44,0,60,529,4960
2007-10-03,141,4053,126,44,0,60,530,4954
2007-10-02,142,4049,126,44,0,61,529,4951
2007-10-01,141,4034,126,44,0,61,521,4927
2007-09-28,142,4009,125,44,0,59,527,4906
2007-09-27,149,3982,125,44,0,60,543,4903
2007-09-26,148,3973,125,44,0,59,551,4900
2007-09-25,151,3962,126,47,0,58,545,4889
2007-09-24,150,3993,126,47,0,57,540,4913
2007-09-21,151,3980,127,47,0,56,532,4893
2007-09-20,150,3985,126,46,0,54,534,4895
2007-09-19,149,3969,125,46,0,54,517,4860
2007-09-18,147,3967,125,46,0,54,520,4859
2007-09-17,145,3949,125,47,0,52,521,4839
2007-09-14,146,3963,125,47,0,52,520,4853
2007-09-13,149,3932,125,46,0,52,520,4824
2007-09-12,148,3900,125,46,0,52,508,4779
2007-09-11,148,3887,125,46,0,56,502,4764
2007-09-10,147,3887,124,46,0,58,504,4766
2007-09-07,146,3892,123,47,0,59,503,4770
2007-09-06,143,3888,123,46,0,58,496,4754
2007-09-05,141,3880,123,46,0,58,493,4741
2007-09-04,141,3881,122,46,0,60,490,4740
2007-09-03,141,3876,122,46,0,61,493,4739
2007-08-31,142,3874,122,43,0,61,477,4719
2007-08-30,142,3820,122,46,0,62,471,4663
2007-08-29,144,3800,117,45,0,61,476,4643
2007-08-28,143,3788,116,45,0,60,475,4627
2007-08-27,144,3789,116,45,0,59,477,4630
2007-08-24,144,3785,116,45,0,58,494,4642
2007-08-23,144,3800,116,44,0,57,488,4649
2007-08-22,144,3808,116,43,0,57,489,4657
2007-08-21,142,3806,117,42,0,55,489,4651
2007-08-17,142,3794,117,42,0,54,485,4634
2007-08-16,142,3788,117,41,0,54,484,4626
2007-08-15,141,3774,117,41,0,53,477,4603
2007-08-14,141,3768,118,39,0,53,465,4584
2007-08-13,140,3757,118,40,0,52,467,4574
2007-08-10,140,3757,118,43,0,51,463,4572
2007-08-09,141,3745,118,41,0,51,467,4563
2007-08-08,141,3711,118,41,0,52,462,4525
2007-08-07,141,3708,118,41,0,54,463,4525
2007-08-06,141,3736,118,41,0,56,460,4552
2007-08-03,141,3725,118,41,0,55,460,4540
2007-08-02,140,3716,118,41,0,55,459,4529
2007-08-01,140,3703,114,41,0,56,455,4509
2007-07-31,139,3690,113,40,0,56,453,4491
2007-07-30,141,3663,112,41,0,55,465,4477
2007-07-27,142,3636,112,41,0,55,463,4449
2007-07-26,141,3633,112,41,0,54,463,4444
2007-07-25,142,3612,111,41,0,53,461,4420
2007-07-24,142,3619,112,41,0,53,451,4418
2007-07-23,142,3625,112,41,0,51,450,4421
2007-07-20,144,3630,112,41,0,51,450,4428
2007-07-19,142,3615,112,41,0,50,448,4408
2007-07-18,141,3609,112,41,0,49,447,4399
2007-07-17,141,3619,112,41,0,49,443,4405
2007-07-16,140,3637,112,41,0,48,439,4417
2007-07-13,139,3598,112,41,0,48,434,4372
2007-07-12,139,3589,112,41,0,50,433,4364
2007-07-11,140,3568,112,41,0,51,438,4350
2007-07-10,143,3567,107,40,0,52,434,4343
2007-07-06,143,3565,108,40,0,53,433,4342
2007-07-05,147,3553,108,40,0,53,423,4324
2007-07-04,145,3529,108,40,0,53,427,4302
2007-07-03,146,3535,108,40,0,55,424,4308
2007-07-02,145,3528,108,40,0,56,418,4295
2007-06-29,143,3512,108,40,0,54,429,4286
2007-06-28,142,3494,108,40,0,55,420,4259
2007-06-27,143,3479,106,40,0,54,418,4240
2007-06-26,143,3479,106,39,0,54,415,4236
2007-06-25,146,3476,102,40,0,54,420,4238
2007-06-22,147,3477,102,40,0,52,422,4240
2007-06-21,147,3451,102,39,0,52,422,4213
2007-06-20,147,3444,102,39,0,52,421,4205
2007-06-19,146,3456,101,39,0,51,420,4213
2007-06-15,148,3466,101,40,0,51,428,4234
2007-06-14,145,3463,103,39,0,51,424,4225
2007-06-13,145,3465,103,39,0,54,424,4230
2007-06-12,143,3453,103,39,0,57,426,4221
2007-06-11,143,3436,103,39,0,57,428,4206
2007-06-08,143,3435,103,39,0,58,430,4208
2007-06-07,144,3427,103,39,0,58,431,4202
2007-06-06,145,3438,103,39,0,58,431,4214
2007-06-05,145,3456,103,39,0,59,430,4232
2007-06-04,141,3453,104,39,0,60,431,4228
2007-06-01,141,3467,103,39,0,60,431,4241
2007-05-31,139,3451,103,39,0,58,449,4239
2007-05-30,139,3468,101,38,0,59,426,4231
2007-05-29,140,3445,101,38,0,57,426,4207
2007-05-28,140,3440,101,38,0,56,428,4203
2007-05-24,141,3447,101,39,0,55,421,4204
2007-05-23,141,3444,101,39,0,54,423,4202
2007-05-22,143,3448,101,39,0,54,422,4207
2007-05-21,143,3457,101,38,0,53,424,4216
2007-05-18,147,3441,101,38,0,51,421,4199
2007-05-17,146,3441,101,39,0,50,422,4199
2007-05-16,147,3435,101,39,0,49,422,4193
2007-05-15,148,3427,101,38,0,49,414,4177
2007-05-14,147,3433,101,38,0,48,413,4180
2007-05-11,147,3432,101,38,0,48,414,4180
2007-05-10,150,3427,101,38,0,49,412,4177
2007-05-09,150,3405,101,38,0,50,409,4153
2007-05-08,149,3382,101,38,0,51,413,4134
2007-05-07,145,3394,101,38,0,52,425,4155
2007-05-04,146,3386,101,38,0,53,422,4146
2007-05-03,146,3381,101,38,0,54,422,4142
2007-05-02,146,3391,101,38,0,54,421,4151
2007-04-30,147,3368,101,38,0,54,438,4146
2007-04-27,144,3365,101,37,0,55,445,4147
2007-04-26,148,3355,101,37,0,54,448,4143
2007-04-25,148,3348,101,37,0,53,456,4143
2007-04-24,148,3329,101,37,0,53,448,4116
2007-04-23,148,3327,101,37,0,53,447,4113
2007-04-20,150,3319,101,37,0,53,450,4110
2007-04-19,154,3304,101,37,0,51,449,4096
2007-04-18,152,3293,101,37,0,51,448,4082
2007-04-17,153,3301,101,37,0,51,448,4091
2007-04-16,153,3302,101,37,0,52,448,4093
2007-04-13,153,3304,101,37,0,53,450,4098
2007-04-12,153,3303,101,37,0,53,445,4092
2007-04-11,153,3312,101,37,0,54,436,4093
2007-04-10,151,3290,101,37,0,54,439,4072
2007-04-09,151,3285,101,37,0,53,440,4067
2007-04-04,151,3280,101,37,0,52,438,4059
2007-04-03,152,3265,101,37,0,54,433,4042
2007-03-30,153,3263,101,38,0,53,443,4051
2007-03-29,153,3252,100,37,0,53,452,4047
2007-03-28,154,3232,99,37,0,52,450,4024
2007-03-27,153,3220,99,37,0,52,449,4010
2007-03-26,152,3219,99,37,0,51,459,4017
2007-03-23,152,3218,97,37,0,51,455,4010
2007-03-22,151,3211,97,37,0,49,452,3997
2007-03-21,148,3187,97,37,0,49,450,3968
2007-03-20,152,3194,97,37,0,49,455,3984
2007-03-19,152,3173,97,37,0,50,453,3962
2007-03-16,152,3189,97,37,0,49,454,3978
2007-03-15,152,3185,97,37,0,50,453,3974
2007-03-14,152,3179,97,37,0,53,447,3965
2007-03-13,147,3176,95,37,0,54,457,3966
2007-03-12,147,3184,96,37,0,57,451,3972
2007-03-09,147,3181,96,37,0,57,450,3968
2007-03-08,146,3168,96,36,0,56,451,3953
2007-03-07,146,3173,96,36,0,57,442,3950
2007-03-06,146,3164,96,36,0,58,434,3934
2007-03-05,147,3157,96,36,0,60,433,3929
2007-03-02,147,3166,96,36,0,61,433,3939
2007-03-01,152,3158,96,36,0,60,430,3932
2007-02-28,145,3131,95,36,0,58,433,3898
2007-02-27,154,3122,96,36,0,59,438,3905
2007-02-26,149,3116,96,36,0,58,441,3896
2007-02-23,150,3117,96,36,0,57,441,3897
2007-02-22,154,3112,96,37,0,56,444,3899
2007-02-21,156,3100,102,37,0,56,438,3889
2007-02-20,161,3093,102,37,0,56,434,3883
2007-02-19,161,3089,102,37,0,56,432,3877
2007-02-16,161,3095,102,37,0,56,432,3883
2007-02-15,166,3100,100,37,0,56,451,3910
2007-02-14,165,3095,101,37,0,58,445,3901
2007-02-13,165,3087,101,37,0,60,432,3882
2007-02-12,161,3082,101,37,0,62,432,3875
2007-02-09,163,3087,101,37,0,61,430,3879
2007-02-08,163,3087,101,37,0,60,430,3878
2007-02-07,164,3089,101,37,0,60,432,3883
2007-02-06,164,3077,101,37,0,59,437,3875
2007-02-05,165,3058,100,37,0,60,436,3856
2007-02-02,165,3043,101,37,0,60,434,3840
2007-02-01,164,3033,100,37,0,59,433,3826
2007-01-31,165,3006,100,37,0,58,461,3827
2007-01-30,165,3001,100,37,0,57,456,3816
2007-01-29,165,3001,100,37,0,54,454,3811
2007-01-26,167,2995,92,37,0,53,454,3798
2007-01-25,167,2988,92,37,0,51,452,3787
2007-01-24,167,2997,92,37,0,50,454,3797
2007-01-23,168,2975,92,37,0,48,453,3773
2007-01-22,169,2984,92,37,0,47,445,3774
2007-01-19,168,2979,92,37,0,45,443,3764
2007-01-18,168,2984,92,37,0,44,431,3756
2007-01-17,168,2984,92,37,0,43,426,3750
2007-01-16,167,2991,92,37,0,41,435,3763
2007-01-15,168,2980,92,37,0,40,436,3753
2007-01-12,168,2979,92,37,0,39,437,3752
2007-01-11,167,2966,92,37,0,39,436,3737
2007-01-10,167,2955,91,37,0,39,437,3726
2007-01-09,167,2940,91,37,0,40,437,3712
2007-01-08,167,2936,91,37,0,39,437,3707
2007-01-05,171,2933,91,37,0,38,436,3706
2007-01-04,170,2926,91,37,0,37,435,3696
2007-01-03,175,2905,91,37,0,39,423,3670
2007-01-02,175,2909,91,37,0,39,423,3674
2006-12-29,175,2818,91,37,0,38,518,3677
2006-12-28,175,2835,89,37,0,38,533,3707
2006-12-27,176,2818,92,37,0,38,527,3688
2006-12-26,173,2833,92,37,0,38,526,3699
2006-12-22,174,2847,92,37,0,38,525,3713
2006-12-21,174,2844,92,37,0,37,529,3713
2006-12-20,175,2807,92,37,0,37,534,3682
2006-12-19,180,2799,92,37,0,38,525,3671
2006-12-18,180,2785,92,37,0,38,529,3661
2006-12-15,175,2779,92,37,0,37,529,3649
2006-12-14,173,2762,92,37,0,40,524,3628
2006-12-13,173,2750,92,37,0,40,546,3638
2006-12-12,172,2761,92,37,0,42,548,3652
2006-12-11,174,2779,92,37,0,42,537,3661
2006-12-07,173,2760,92,37,0,41,550,3653
2006-12-06,173,2738,91,37,0,41,550,3630
2006-12-05,174,2755,91,37,0,42,555,3654
2006-12-04,176,2789,91,37,0,44,544,3681
2006-12-01,186,2775,91,37,0,43,546,3678
2006-11-30,175,2769,90,37,0,41,543,3655
2006-11-29,187,2760,90,37,0,42,549,3665
2006-11-28,187,2756,90,37,0,42,552,3664
2006-11-27,191,2752,90,37,0,42,555,3667
2006-11-24,192,2750,90,36,0,42,543,3653
2006-11-23,191,2762,90,36,0,41,549,3669
2006-11-22,191,2759,90,36,0,41,549,3666
2006-11-21,192,2747,90,36,0,41,548,3654
2006-11-20,188,2752,90,36,0,41,546,3653
2006-11-17,188,2743,90,36,0,40,546,3643
2006-11-16,191,2730,90,36,0,39,545,3631
2006-11-15,192,2727,90,37,0,39,546,3631
2006-11-14,191,2727,90,37,0,38,541,3624
2006-11-13,191,2739,90,36,0,38,534,3628
2006-11-10,192,2757,90,36,0,37,533,3645
2006-11-09,193,2736,90,36,0,37,526,3618
2006-11-08,192,2733,91,36,0,40,526,3618
2006-11-07,192,2751,91,36,0,41,521,3632
2006-11-03,192,2739,90,36,0,41,514,3612
2006-11-02,187,2724,90,36,0,42,507,3586
2006-11-01,185,2728,90,36,0,42,507,3588
2006-10-31,182,2724,90,36,0,43,501,3576
2006-10-30,182,2731,90,36,0,43,529,3611
2006-10-27,183,2726,92,36,0,42,528,3607
2006-10-26,182,2730,92,36,0,41,529,3610
2006-10-25,182,2724,92,36,0,41,528,3603
2006-10-24,182,2717,92,36,0,40,518,3585
2006-10-23,183,2702,92,36,0,40,515,3568
2006-10-20,183,2699,92,36,0,39,515,3564
2006-10-19,183,2688,92,36,0,38,508,3545
2006-10-18,182,2689,92,36,0,38,509,3546
2006-10-17,181,2678,92,36,0,37,509,3533
2006-10-13,182,2672,92,36,0,36,508,3526
2006-10-12,182,2659,92,36,0,37,507,3513
2006-10-11,182,2662,92,36,0,38,505,3515
2006-10-10,188,2660,92,36,0,39,506,3521
2006-10-09,188,2643,92,36,0,40,509,3508
2006-10-06,188,2637,91,37,0,40,509,3502
2006-10-05,183,2638,92,36,0,39,520,3508
2006-10-04,183,2632,91,36,0,39,520,3501
2006-10-03,183,2624,91,36,0,39,519,3492
2006-10-02,189,2628,92,36,0,41,508,3494
2006-09-29,190,2628,92,36,0,39,513,3498
2006-09-28,190,2623,92,36,0,40,500,3481
2006-09-27,190,2625,92,36,0,39,498,3480
2006-09-26,193,2637,92,36,0,38,490,3486
2006-09-25,190,2629,92,36,0,38,484,3469
2006-09-22,190,2619,92,36,0,37,485,3459
2006-09-21,190,2612,92,36,0,36,485,3451
2006-09-20,190,2604,92,36,0,35,479,3436
2006-09-19,190,2600,92,36,0,35,482,3435
2006-09-18,190,2602,92,35,0,35,499,3453
2006-09-15,190,2606,92,35,0,35,499,3457
2006-09-14,182,2591,92,35,0,35,500,3435
2006-09-13,189,2598,92,35,0,37,491,3442
2006-09-12,183,2576,92,35,0,38,481,3405
2006-09-11,183,2577,92,35,0,39,480,3406
2006-09-08,183,2563,92,35,0,38,471,3382
2006-09-07,183,2578,92,35,0,39,471,3398
2006-09-06,180,2570,92,35,0,39,467,3383
2006-09-05,180,2571,92,36,0,39,469,3387
2006-09-04,178,2560,93,36,0,40,465,3372
2006-09-01,178,2564,93,36,0,41,469,3381
2006-08-31,180,2551,89,35,0,40,469,3364
2006-08-30,181,2548,90,36,0,40,471,3366
2006-08-29,177,2550,90,34,0,40,471,3362
2006-08-28,182,2556,90,34,0,40,469,3371
2006-08-25,183,2558,91,34,0,39,455,3360
2006-08-24,183,2546,91,34,0,38,453,3345
2006-08-23,184,2545,91,34,0,37,449,3340
2006-08-22,182,2531,91,34,0,37,448,3323
2006-08-18,189,2527,90,34,0,36,445,3321
2006-08-17,188,2524,90,34,0,36,453,3325
2006-08-16,187,2514,90,34,0,35,452,3312
2006-08-15,187,2527,90,34,0,34,451,3323
2006-08-14,186,2522,90,34,0,34,456,3322
2006-08-11,198,2507,90,34,0,34,460,3323
2006-08-10,198,2504,91,34,0,34,460,3321
2006-08-09,198,2502,91,34,0,35,455,3315
2006-08-08,198,2494,91,34,0,36,453,3306
2006-08-07,197,2491,91,34,0,37,434,3284
2006-08-04,196,2492,91,34,0,37,433,3283
2006-08-03,197,2490,90,34,0,37,430,3278
2006-08-02,196,2472,90,34,0,37,429,3258
2006-08-01,196,2483,89,34,0,40,427,3269
2006-07-31,195,2481,90,33,0,37,431,3267
2006-07-28,194,2488,89,33,0,40,433,3277
2006-07-27,194,2479,88,33,0,39,429,3262
2006-07-26,195,2472,88,32,0,38,428,3253
2006-07-25,195,2464,88,32,0,38,427,3244
2006-07-24,197,2461,88,31,0,37,425,3239
2006-07-21,197,2444,88,31,0,36,423,3219
2006-07-20,197,2442,88,31,0,35,407,3200
2006-07-19,192,2436,88,31,0,35,412,3194
2006-07-18,192,2437,88,31,0,34,411,3193
2006-07-17,192,2434,88,31,0,35,412,3192
2006-07-14,191,2425,88,31,0,34,413,3182
2006-07-13,192,2423,88,31,0,35,414,3183
2006-07-12,192,2418,88,31,0,37,410,3176
2006-07-11,192,2405,88,31,0,38,416,3170
2006-07-10,187,2384,88,31,0,40,418,3148
2006-07-07,197,2385,88,31,0,40,417,3158
2006-07-06,197,2376,88,31,0,40,419,3151
2006-07-05,201,2374,88,31,0,40,420,3154
2006-07-04,201,2362,88,31,0,40,418,3140
2006-07-03,198,2367,88,31,0,42,419,3145
2006-06-30,198,2363,88,32,0,41,422,3144
2006-06-29,198,2354,87,30,0,42,441,3152
2006-06-28,198,2330,87,30,0,41,440,3126
2006-06-27,198,2334,87,30,0,41,440,3130
2006-06-26,198,2326,88,30,0,40,438,3120
2006-06-23,197,2327,88,30,0,39,433,3114
2006-06-22,198,2320,88,30,0,39,424,3099
2006-06-21,196,2309,88,28,0,38,429,3088
2006-06-20,196,2313,88,28,0,38,429,3092
2006-06-16,196,2312,88,28,0,38,426,3088
2006-06-15,195,2301,88,29,0,38,431,3082
2006-06-14,196,2283,88,29,0,40,427,3063
2006-06-13,195,2290,89,29,0,41,422,3066
2006-06-12,195,2272,89,29,0,43,410,3038
2006-06-09,194,2266,89,29,0,42,429,3049
2006-06-08,195,2268,89,29,0,42,428,3051
2006-06-07,190,2254,89,29,0,42,427,3031
2006-06-06,193,2257,89,29,0,42,426,3036
2006-06-05,193,2251,89,29,0,43,427,3032
2006-06-02,201,2245,89,29,0,43,425,3032
2006-06-01,196,2228,89,29,0,43,424,3009
2006-05-31,196,2225,89,29,0,42,434,3015
2006-05-30,192,2220,89,27,0,42,429,2999
2006-05-29,197,2242,89,27,0,41,437,3033
2006-05-26,196,2237,89,25,0,40,441,3028
2006-05-24,197,2219,88,25,0,39,438,3006
2006-05-23,195,2218,89,25,0,38,434,2999
2006-05-22,196,2225,89,25,0,38,438,3011
2006-05-19,189,2221,89,25,0,37,438,2999
2006-05-18,188,2212,89,25,0,37,436,2987
2006-05-17,190,2205,89,25,0,37,439,2985
2006-05-16,190,2203,89,23,0,37,433,2975
2006-05-15,180,2188,89,22,0,36,434,2949
2006-05-12,180,2176,89,22,0,35,438,2940
2006-05-11,181,2141,89,22,0,35,429,2897
2006-05-10,180,2136,89,22,0,37,434,2898
2006-05-09,180,2129,89,22,0,38,433,2891
2006-05-08,178,2136,89,22,0,38,433,2896
2006-05-05,178,2116,89,22,0,38,430,2873
2006-05-04,179,2113,89,20,0,38,428,2867
2006-05-03,179,2111,89,20,0,38,427,2864
2006-05-02,179,2118,89,20,0,39,429,2874
2006-04-28,179,2122,91,23,0,38,439,2892
2006-04-27,194,2093,89,20,0,38,427,2861
2006-04-26,193,2086,89,20,0,37,423,2848
2006-04-25,195,2093,88,20,0,37,417,2850
2006-04-24,195,2071,88,20,0,37,425,2836
2006-04-21,195,2043,88,20,0,36,426,2808
2006-04-20,196,2036,88,16,0,35,424,2795
2006-04-19,197,2007,88,16,0,36,407,2751
2006-04-18,196,2003,88,16,0,35,408,2746
2006-04-17,197,1979,88,16,0,35,402,2717
2006-04-12,195,1956,88,16,0,35,397,2687
2006-04-11,195,1952,88,16,0,38,396,2685
2006-04-10,194,1933,87,16,0,39,396,2665
2006-04-07,189,1934,87,17,0,39,394,2660
2006-04-06,189,1915,87,17,0,39,380,2627
2006-04-05,188,1920,87,17,0,40,373,2625
2006-04-04,188,1918,87,17,0,40,373,2623
2006-04-03,182,1918,87,17,0,42,374,2620
2006-03-31,186,1908,87,17,0,41,378,2617
2006-03-30,189,1892,87,17,0,42,385,2612
2006-03-29,188,1887,87,17,0,41,395,2615
2006-03-28,186,1871,86,17,0,41,391,2592
2006-03-27,184,1878,86,17,0,40,392,2597
2006-03-23,183,1880,86,17,0,39,400,2605
2006-03-22,183,1857,86,17,0,39,391,2573
2006-03-21,183,1847,86,16,0,39,386,2557
2006-03-20,183,1841,86,16,0,40,383,2549
2006-03-17,184,1832,87,16,0,41,379,2539
2006-03-16,182,1814,87,16,0,42,375,2516
2006-03-15,179,1793,87,16,0,44,371,2490
2006-03-14,179,1776,86,17,0,45,374,2477
2006-03-13,178,1816,86,19,0,48,372,2519
2006-03-10,178,1808,86,19,0,48,369,2508
2006-03-09,181,1802,86,19,0,48,370,2506
2006-03-08,181,1771,85,17,0,48,369,2471
2006-03-07,181,1760,85,17,0,48,352,2443
2006-03-06,181,1746,85,17,0,52,345,2426
2006-03-03,181,1758,85,18,0,52,345,2439
2006-03-02,181,1755,85,18,0,52,346,2437
2006-03-01,182,1752,85,18,0,51,350,2438
2006-02-28,182,1748,86,18,0,48,350,2432
2006-02-27,177,1740,85,18,0,50,360,2430
2006-02-24,177,1740,85,17,0,49,353,2421
2006-02-23,181,1723,85,17,0,48,352,2406
2006-02-22,182,1717,85,17,0,48,353,2402
2006-02-21,182,1728,84,17,0,47,340,2398
2006-02-20,207,1704,92,20,0,47,334,2404
2006-02-17,214,1709,92,20,0,46,333,2414
2006-02-16,188,1698,84,19,0,45,332,2366
2006-02-15,195,1699,84,19,0,45,330,2372
2006-02-14,195,1694,84,19,0,44,323,2359
2006-02-13,195,1687,84,19,0,43,332,2360
2006-02-10,195,1683,85,19,0,42,338,2362
2006-02-09,195,1669,85,19,0,42,341,2351
2006-02-08,195,1671,84,19,0,43,337,2349
2006-02-07,196,1664,85,19,0,42,340,2346
2006-02-06,195,1655,85,19,0,43,345,2342
2006-02-03,194,1647,85,18,0,43,358,2345
2006-02-02,189,1636,85,18,0,42,346,2316
2006-02-01,188,1628,85,18,0,42,352,2313
2006-01-31,188,1630,85,19,0,43,356,2321
2006-01-30,189,1658,85,17,0,42,349,2340
2006-01-27,189,1670,85,17,0,40,351,2352
2006-01-26,189,1669,85,17,0,39,354,2353
2006-01-25,190,1672,85,17,0,38,354,2356
2006-01-24,190,1672,85,17,0,37,355,2356
2006-01-23,190,1673,85,17,0,36,356,2357
2006-01-20,190,1650,85,17,0,34,362,2338
2006-01-19,190,1676,85,17,0,33,361,2362
2006-01-18,190,1680,85,17,0,32,350,2354
2006-01-17,190,1664,85,17,0,32,351,2339
2006-01-16,190,1667,85,17,0,31,351,2341
2006-01-13,191,1669,85,17,0,30,352,2344
2006-01-12,190,1650,83,17,0,29,351,2320
2006-01-11,191,1630,83,17,0,31,345,2297
2006-01-10,190,1662,83,17,0,31,342,2325
2006-01-09,181,1661,84,17,0,31,340,2314
2006-01-06,180,1651,84,17,0,31,341,2304
2006-01-05,180,1646,84,17,0,30,345,2302
2006-01-04,180,1644,84,17,0,30,350,2305
2006-01-03,181,1652,80,17,0,30,350,2310
2006-01-02,181,1646,80,16,0,31,348,2302
2005-12-30,184,1647,80,18,0,30,348,2307
2005-12-29,184,1637,80,15,0,30,353,2299
2005-12-28,180,1628,80,15,0,30,330,2263
2005-12-27,176,1630,79,15,0,30,326,2256
2005-12-26,178,1616,78,15,0,30,332,2249
2005-12-23,179,1618,80,15,0,30,340,2262
2005-12-22,174,1641,78,15,0,29,326,2263
2005-12-21,177,1631,78,15,0,29,336,2266
2005-12-20,174,1628,85,16,0,29,326,2258
2005-12-19,178,1649,78,16,0,29,326,2276
2005-12-16,183,1638,78,16,0,29,324,2268
2005-12-15,193,1635,78,16,0,31,339,2292
2005-12-14,194,1632,76,16,0,32,364,2314
2005-12-13,195,1649,76,16,0,33,366,2335
2005-12-12,193,1650,76,15,0,33,366,2333
2005-12-09,193,1648,75,15,0,33,343,2307
2005-12-07,193,1643,75,15,0,33,341,2300
2005-12-06,192,1646,75,16,0,33,344,2306
2005-12-05,191,1661,75,16,0,34,344,2321
2005-12-02,196,1645,75,16,0,35,362,2329
2005-12-01,197,1662,75,16,0,34,354,2338
2005-11-30,195,1658,74,16,0,34,351,2328
2005-11-29,192,1651,74,16,0,34,345,2312
2005-11-28,201,1649,74,16,0,34,345,2319
2005-11-25,201,1650,74,16,0,33,343,2317
2005-11-24,201,1650,74,16,0,33,343,2317
2005-11-23,202,1652,74,16,0,32,345,2321
2005-11-22,201,1644,74,16,0,32,334,2301
2005-11-21,204,1642,71,16,0,32,329,2294
2005-11-18,203,1636,71,16,0,32,330,2288
2005-11-17,195,1635,71,16,0,31,328,2276
2005-11-16,196,1623,71,16,0,31,318,2255
2005-11-15,195,1607,71,16,0,30,320,2239
2005-11-14,195,1591,71,16,0,30,322,2225
2005-11-11,195,1591,71,18,0,30,317,2222
2005-11-10,195,1594,71,18,0,30,319,2227
2005-11-09,195,1603,71,16,0,32,324,2241
2005-11-08,195,1599,71,16,0,34,328,2243
2005-11-07,196,1600,71,16,0,34,326,2243
2005-11-04,197,1614,71,16,0,33,325,2256
2005-11-03,197,1602,70,16,0,33,325,2243
2005-11-02,197,1604,71,16,0,34,331,2253
2005-11-01,197,1604,70,16,0,34,336,2257
2005-10-31,198,1602,70,16,0,34,335,2255
2005-10-28,198,1590,69,16,0,34,346,2253
2005-10-27,198,1592,69,16,0,34,334,2243
2005-10-26,199,1593,69,16,0,33,331,2241
2005-10-25,199,1597,69,16,0,33,330,2244
2005-10-24,199,1617,69,16,0,33,322,2256
2005-10-21,198,1599,69,16,0,32,347,2261
2005-10-20,198,1597,69,16,0,31,342,2253
2005-10-19,206,1593,68,16,0,31,342,2256
2005-10-18,209,1591,68,16,0,31,343,2258
2005-10-17,207,1598,68,16,0,31,349,2269
2005-10-14,207,1622,68,16,0,31,331,2275
2005-10-13,208,1623,68,17,0,32,331,2279
2005-10-12,208,1635,68,17,0,34,332,2294
2005-10-11,208,1639,68,16,0,33,334,2298
2005-10-07,208,1647,68,16,0,33,335,2307
2005-10-06,208,1653,68,16,0,33,337,2315
2005-10-05,209,1656,68,16,0,33,337,2319
2005-10-04,209,1657,68,16,0,32,337,2319
2005-10-03,210,1663,68,16,0,33,341,2331
2005-09-30,209,1669,68,13,0,33,359,2351
2005-09-29,212,1683,63,13,0,32,341,2344
2005-09-28,213,1683,62,13,0,31,342,2344
2005-09-27,213,1686,62,13,0,31,344,2349
2005-09-26,213,1704,62,13,0,30,346,2368
2005-09-23,215,1716,62,13,0,30,349,2385
2005-09-22,220,1728,61,13,0,29,355,2406
2005-09-21,220,1734,61,13,0,29,361,2418
2005-09-20,220,1733,61,13,0,28,362,2417
2005-09-19,220,1745,62,13,0,28,369,2437
2005-09-16,220,1758,62,13,0,28,367,2448
2005-09-15,221,1762,62,13,0,28,371,2457
2005-09-14,221,1758,60,13,0,29,374,2455
2005-09-13,223,1760,59,13,0,33,370,2458
2005-09-12,228,1795,59,13,0,33,371,2499
2005-09-09,229,1798,59,13,0,34,372,2505
2005-09-08,231,1808,57,13,0,33,372,2514
2005-09-07,230,1785,57,13,0,33,374,2492
2005-09-06,230,1787,57,13,0,33,373,2493
2005-09-05,225,1781,58,14,0,34,362,2474
2005-09-02,224,1782,57,13,0,34,362,2472
2005-09-01,224,1779,57,13,0,33,361,2467
2005-08-31,225,1776,57,13,0,34,371,2476
2005-08-30,227,1774,57,14,0,33,358,2463
2005-08-29,228,1768,57,14,0,33,367,2467
2005-08-26,220,1760,57,14,0,33,364,2448
2005-08-25,218,1746,57,14,0,32,365,2432
2005-08-24,220,1744,57,14,0,32,364,2431
2005-08-23,219,1736,57,14,0,32,364,2422
2005-08-22,217,1730,57,14,0,30,363,2411
2005-08-19,217,1713,57,14,0,31,366,2398
2005-08-18,214,1709,57,14,0,29,358,2381
2005-08-17,219,1698,57,14,0,29,358,2375
2005-08-16,219,1705,57,14,0,29,359,2383
2005-08-12,220,1716,57,14,0,29,359,2395
2005-08-11,220,1703,57,13,0,30,357,2380
2005-08-10,219,1702,57,13,0,28,362,2381
2005-08-09,214,1694,57,13,0,29,359,2366
2005-08-08,214,1692,57,13,0,30,361,2367
2005-08-05,214,1681,57,13,0,31,352,2348
2005-08-04,215,1676,57,13,0,30,350,2341
2005-08-03,215,1665,57,13,0,31,353,2334
2005-08-02,212,1648,57,13,0,31,347,2308
2005-08-01,213,1658,57,13,0,31,344,2316
2005-07-29,213,1652,57,14,0,31,358,2325
2005-07-28,213,1643,57,14,0,32,343,2302
2005-07-27,215,1645,57,13,0,31,337,2298
2005-07-26,216,1640,57,13,0,31,336,2293
2005-07-25,216,1620,57,13,0,30,340,2276
2005-07-22,220,1632,56,13,0,30,342,2293
2005-07-21,222,1654,56,13,0,29,339,2313
2005-07-20,214,1646,56,13,0,28,345,2302
2005-07-19,213,1665,56,13,0,28,346,2321
2005-07-18,212,1664,56,13,0,27,348,2320
2005-07-15,212,1651,56,13,0,27,352,2311
2005-07-14,212,1636,56,13,0,27,355,2299
2005-07-13,208,1591,56,13,0,27,353,2248
2005-07-12,210,1564,58,14,0,29,345,2220
2005-07-11,211,1558,58,14,0,31,343,2215
2005-07-08,208,1559,58,13,0,30,344,2212
2005-07-07,208,1560,58,13,0,30,345,2214
2005-07-06,211,1558,58,14,0,30,350,2221
2005-07-05,194,1553,58,14,0,31,339,2189
2005-07-04,192,1553,58,14,0,31,341,2189
2005-07-01,197,1552,58,14,0,32,342,2195
2005-06-30,186,1547,58,14,0,31,340,2176
2005-06-29,185,1544,57,14,0,31,356,2187
2005-06-28,184,1529,58,14,0,31,357,2173
2005-06-27,184,1517,58,14,0,30,344,2147
2005-06-24,185,1504,57,14,0,29,347,2136
2005-06-23,181,1484,57,14,0,28,339,2103
2005-06-22,180,1471,57,14,0,28,336,2086
2005-06-21,179,1444,57,14,0,27,334,2055
2005-06-17,180,1430,57,14,0,27,329,2037
2005-06-16,178,1413,56,14,0,27,335,2023
2005-06-15,168,1406,56,14,0,27,332,2003
2005-06-14,169,1382,54,15,0,26,334,1980
2005-06-13,168,1389,56,12,0,26,334,1985
2005-06-10,168,1341,56,12,0,25,334,1936
2005-06-09,168,1363,54,14,0,25,336,1960
2005-06-08,168,1362,54,12,0,26,336,1958
2005-06-07,168,1343,54,12,0,27,320,1924
2005-06-06,168,1336,54,12,0,28,323,1921
2005-06-03,168,1326,54,12,0,28,322,1910
2005-06-02,169,1308,54,12,0,29,320,1892
2005-06-01,168,1294,54,12,0,30,324,1882
2005-05-31,168,1283,54,15,0,30,335,1885
2005-05-30,166,1277,54,12,0,29,324,1862
2005-05-27,166,1282,54,12,0,29,326,1869
2005-05-26,161,1292,54,12,0,28,326,1873
2005-05-24,156,1300,54,12,0,27,326,1875
2005-05-23,153,1305,54,13,0,27,323,1875
2005-05-20,153,1293,56,12,0,26,324,1864
2005-05-19,153,1289,56,13,0,26,322,1859
2005-05-18,150,1300,56,13,0,26,324,1869
2005-05-17,150,1287,56,13,0,27,320,1853
2005-05-16,148,1273,56,13,0,27,319,1836
2005-05-13,149,1279,56,13,0,26,319,1842
2005-05-12,151,1279,56,12,0,27,318,1843
2005-05-11,155,1274,56,12,0,28,322,1847
2005-05-10,155,1278,56,13,0,28,325,1855
2005-05-09,155,1274,56,13,0,28,324,1850
2005-05-06,152,1268,56,13,0,29,320,1838
2005-05-05,152,1264,56,13,0,29,326,1840
2005-05-04,153,1271,56,13,0,29,323,1845
2005-05-03,153,1271,56,13,0,29,330,1852
2005-05-02,152,1275,56,12,0,30,329,1854
2005-04-29,152,1269,56,12,0,29,340,1858
2005-04-28,146,1260,55,13,0,29,331,1834
2005-04-27,146,1258,55,13,0,29,333,1834
2005-04-26,154,1248,55,13,0,28,330,1828
2005-04-25,153,1244,55,13,0,28,332,1825
2005-04-22,156,1245,55,13,0,27,331,1827
2005-04-21,153,1235,54,13,0,27,322,1804
2005-04-20,154,1236,54,13,0,26,324,1807
2005-04-19,154,1233,54,13,0,26,327,1807
2005-04-18,154,1239,54,13,0,26,327,1813
2005-04-15,159,1238,55,13,0,27,327,1819
2005-04-14,157,1240,54,13,0,27,328,1819
2005-04-13,161,1239,54,13,0,30,329,1826
2005-04-12,161,1240,54,13,0,30,329,1827
2005-04-11,161,1239,54,13,0,31,330,1828
2005-04-08,160,1237,54,13,0,32,328,1824
2005-04-07,157,1236,54,13,0,32,329,1821
2005-04-06,158,1221,55,13,0,31,329,1807
2005-04-05,158,1234,55,13,0,31,330,1821
2005-04-04,158,1241,55,15,0,33,331,1833
2005-04-01,158,1227,55,15,0,34,331,1820
2005-03-31,158,1232,55,13,0,33,338,1829
2005-03-30,162,1231,55,15,0,33,333,1829
2005-03-29,161,1220,55,15,0,32,333,1816
2005-03-28,161,1211,55,15,0,32,330,1804
2005-03-23,161,1213,55,15,0,31,333,1808
2005-03-22,161,1161,55,15,0,32,331,1755
2005-03-21,161,1153,55,15,0,32,332,1748
2005-03-18,161,1140,55,14,0,33,325,1728
2005-03-17,160,1143,55,15,0,33,330,1736
2005-03-16,153,1138,55,15,0,34,330,1725
2005-03-15,154,1136,54,15,0,37,326,1722
2005-03-14,154,1133,54,15,0,39,326,1721
2005-03-11,153,1116,54,15,0,40,327,1705
2005-03-10,153,1111,54,15,0,39,318,1690
2005-03-09,153,1104,54,15,0,39,318,1683
2005-03-08,153,1108,54,15,0,40,317,1687
2005-03-07,153,1104,54,15,0,40,317,1683
2005-03-04,153,1098,51,15,0,41,312,1670
2005-03-03,153,1097,51,15,0,41,313,1670
2005-03-02,152,1095,51,14,0,41,310,1663
2005-03-01,150,1091,51,14,0,41,305,1652
2005-02-28,150,1089,55,13,0,40,312,1659
2005-02-25,150,1082,51,15,0,40,315,1653
2005-02-24,150,1077,51,15,0,39,316,1648
2005-02-23,151,1080,51,13,0,39,315,1649
2005-02-22,149,1079,51,13,0,38,313,1643
2005-02-21,146,1076,52,13,0,38,314,1639
2005-02-18,146,1078,51,13,0,37,312,1637
2005-02-17,145,1076,52,13,0,36,313,1635
2005-02-16,145,1076,52,13,0,35,313,1634
2005-02-15,144,1062,51,13,0,34,315,1619
2005-02-14,144,1061,51,13,0,34,315,1618
2005-02-11,140,1051,51,13,0,34,308,1597
2005-02-10,139,1044,51,13,0,33,309,1589
2005-02-09,141,1046,51,13,0,34,309,1594
2005-02-08,141,1040,51,13,0,35,308,1588
2005-02-07,141,1041,51,13,0,36,309,1591
2005-02-04,139,1076,51,12,0,36,317,1631
2005-02-03,139,1037,51,13,0,36,312,1588
2005-02-02,140,1036,51,12,0,35,313,1587
2005-02-01,139,1039,51,13,0,35,311,1588
2005-01-31,139,1037,55,12,0,34,299,1576
2005-01-28,140,1034,52,12,0,33,315,1586
2005-01-27,139,1051,52,12,0,32,302,1588
2005-01-26,139,1048,52,12,0,31,303,1585
2005-01-25,139,1047,52,12,0,30,303,1583
2005-01-24,139,1036,52,12,0,29,306,1574
2005-01-21,139,1031,52,12,0,28,307,1569
2005-01-20,141,1030,52,12,0,27,305,1567
2005-01-19,141,1029,52,12,0,26,304,1564
2005-01-18,141,1034,52,12,0,25,305,1569
2005-01-17,144,1027,52,12,0,24,303,1562
2005-01-14,144,1022,52,12,0,24,307,1561
2005-01-13,143,1024,50,12,0,24,310,1563
2005-01-12,137,1012,50,12,0,23,310,1544
2005-01-11,137,1015,50,12,0,25,309,1548
2005-01-10,138,1014,50,12,0,25,310,1549
2005-01-07,139,1016,50,12,0,25,311,1553
2005-01-06,143,1060,50,12,0,24,314,1603
2005-01-05,143,1050,50,12,0,24,312,1591
2005-01-04,143,1009,50,12,0,24,311,1549
2005-01-03,141,1010,50,12,0,25,313,1551
2004-12-31,142,1008,50,12,0,25,289,1526
2004-12-30,142,1007,48,12,0,25,334,1568
2004-12-29,153,988,47,12,0,25,337,1562
2004-12-28,155,988,47,12,0,24,336,1562
2004-12-27,153,988,47,12,0,25,339,1564
2004-12-24,153,987,47,12,0,24,337,1560
2004-12-23,155,987,46,12,0,24,337,1561
2004-12-22,154,977,46,12,0,24,348,1561
2004-12-21,150,970,46,12,0,24,350,1552
2004-12-20,144,965,46,12,0,24,349,1540
2004-12-17,144,927,46,12,0,24,352,1505
2004-12-16,143,924,46,12,0,25,354,1504
2004-12-15,143,927,43,12,0,26,354,1505
2004-12-14,144,929,43,12,0,27,359,1514
2004-12-13,143,930,43,12,0,28,357,1513
2004-12-10,145,931,43,12,0,28,358,1517
2004-12-09,145,923,43,12,0,28,358,1509
2004-12-07,144,920,42,12,0,28,357,1503
2004-12-06,139,907,42,12,0,29,357,1486
2004-12-03,139,906,43,13,0,29,356,1486
2004-12-02,138,900,43,13,0,29,360,1483
2004-12-01,138,899,43,13,0,29,355,1477
2004-11-30,139,891,43,13,0,28,335,1449
2004-11-29,138,898,43,13,0,28,345,1465
2004-11-26,143,897,43,13,0,28,345,1469
2004-11-25,143,894,43,13,0,27,333,1453
2004-11-24,142,895,43,13,0,27,331,1451
2004-11-23,142,884,43,13,0,27,328,1437
2004-11-22,143,875,42,13,0,27,327,1427
2004-11-19,142,876,42,12,0,27,327,1426
2004-11-18,141,870,42,12,0,26,327,1418
2004-11-17,141,865,42,12,0,26,327,1413
2004-11-16,141,866,42,12,0,25,331,1417
2004-11-15,141,864,41,12,0,25,332,1415
2004-11-12,140,858,41,12,0,25,334,1410
2004-11-11,140,876,41,12,0,25,333,1427
2004-11-10,140,877,41,12,0,25,335,1430
2004-11-09,134,867,41,12,0,27,339,1420
2004-11-08,134,848,41,12,0,28,357,1420
2004-11-05,131,848,41,12,0,27,357,1416
2004-11-04,131,846,43,12,0,27,357,1416
2004-11-03,131,851,40,10,0,27,358,1417
2004-11-02,130,852,40,10,0,28,357,1417
2004-11-01,132,846,40,10,0,28,357,1413
2004-10-29,136,846,41,18,0,28,343,1412
2004-10-28,138,835,39,16,0,28,359,1415
2004-10-27,139,825,39,16,0,28,362,1409
2004-10-26,139,822,39,16,0,28,352,1396
2004-10-25,139,820,39,16,0,27,362,1403
2004-10-22,139,821,40,16,0,26,361,1403
2004-10-21,140,812,40,16,0,25,362,1395
2004-10-20,140,808,40,16,0,25,362,1391
2004-10-19,140,803,40,16,0,25,388,1412
2004-10-18,143,795,39,16,0,25,374,1392
2004-10-15,142,797,39,16,0,25,377,1396
2004-10-14,139,792,39,16,0,25,375,1386
2004-10-13,138,791,39,10,0,26,372,1376
2004-10-12,140,781,39,16,0,27,370,1373
2004-10-08,139,782,38,16,0,27,366,1368
2004-10-07,139,781,38,16,0,27,382,1383
2004-10-06,139,782,38,16,0,27,382,1384
2004-10-05,140,773,38,16,0,27,384,1378
2004-10-04,140,775,38,16,0,27,385,1381
2004-10-01,139,778,35,16,0,27,385,1380
2004-09-30,138,767,39,16,0,26,379,1365
2004-09-29,139,774,35,16,0,26,386,1376
2004-09-28,142,773,35,16,0,26,387,1379
2004-09-27,142,771,35,16,0,25,386,1375
2004-09-24,142,773,35,14,0,25,383,1372
2004-09-23,142,764,35,14,0,24,378,1357
2004-09-22,144,760,35,14,0,24,378,1355
2004-09-21,151,762,35,14,0,23,380,1365
2004-09-20,151,759,35,14,0,23,381,1363
2004-09-17,150,764,35,15,0,23,381,1368
2004-09-16,151,764,35,16,0,22,378,1366
2004-09-15,159,767,35,16,0,22,384,1383
2004-09-14,159,766,35,15,0,22,386,1383
2004-09-13,159,763,35,15,0,22,385,1379
2004-09-10,159,752,36,15,0,21,385,1368
2004-09-09,160,765,34,16,0,21,397,1393
2004-09-08,160,773,34,16,0,22,394,1399
2004-09-07,162,775,34,16,0,23,395,1405
2004-09-06,161,771,34,16,0,23,393,1398
2004-09-03,161,773,34,16,0,23,394,1401
2004-09-02,161,772,34,16,0,24,394,1401
2004-09-01,161,764,34,16,0,24,394,1393
2004-08-31,160,765,35,18,0,24,370,1372
2004-08-30,161,759,34,16,0,24,388,1382
2004-08-27,160,783,34,16,0,24,387,1404
2004-08-26,163,783,34,16,0,24,389,1409
2004-08-25,162,771,34,16,0,23,393,1399
2004-08-24,162,765,34,16,0,23,394,1394
2004-08-23,163,759,34,16,0,23,393,1388
2004-08-20,163,756,34,16,0,22,391,1382
2004-08-19,163,755,34,16,0,22,399,1389
2004-08-18,163,750,34,16,0,22,398,1383
2004-08-17,165,750,34,16,0,22,395,1382
2004-08-13,165,749,34,16,0,22,393,1379
2004-08-12,166,751,34,16,0,22,392,1381
2004-08-11,166,751,34,16,0,22,393,1382
2004-08-10,165,749,34,16,0,24,396,1384
2004-08-09,166,748,34,15,0,25,393,1381
2004-08-06,166,748,33,15,0,25,395,1382
2004-08-05,172,743,33,15,0,25,394,1382
2004-08-04,172,742,34,15,0,25,411,1399
2004-08-03,172,735,34,15,0,25,410,1391
2004-08-02,172,730,34,15,0,26,396,1373
2004-07-30,173,738,34,15,0,25,382,1367
2004-07-29,172,726,33,16,0,25,374,1346
2004-07-28,175,716,33,16,0,25,372,1337
2004-07-27,175,716,33,16,0,24,370,1334
2004-07-26,175,682,33,16,0,24,355,1285
2004-07-23,180,680,33,16,0,23,354,1286
2004-07-22,181,679,33,15,0,23,354,1285
2004-07-21,180,682,33,15,0,22,355,1287
2004-07-20,181,685,33,15,0,22,355,1291
2004-07-19,181,661,33,15,0,22,364,1276
2004-07-16,181,658,33,15,0,22,364,1273
2004-07-15,181,675,33,15,0,22,356,1282
2004-07-14,181,674,33,15,0,24,356,1283
2004-07-13,181,688,33,15,0,24,355,1296
2004-07-12,182,683,33,15,0,25,357,1295
2004-07-08,182,680,33,15,0,25,356,1291
2004-07-07,180,678,33,15,0,25,354,1285
2004-07-06,181,677,33,15,0,26,356,1288
2004-07-05,180,671,33,15,0,28,361,1288
2004-07-02,183,672,32,15,0,27,361,1290
2004-07-01,183,677,32,15,0,26,363,1296
2004-06-30,183,682,33,15,0,26,360,1299
2004-06-29,184,654,31,14,0,26,374,1283
2004-06-28,186,647,31,16,0,25,369,1274
2004-06-25,186,651,31,16,0,25,373,1282
2004-06-24,177,642,31,14,0,25,326,1215
2004-06-23,178,638,31,14,0,25,325,1211
2004-06-22,177,638,31,14,0,25,325,1210
2004-06-18,176,630,31,14,0,25,322,1198
2004-06-17,175,641,31,14,1,24,325,1211
2004-06-16,179,641,31,14,1,24,328,1218
2004-06-15,180,639,31,14,0,24,328,1216
2004-06-14,180,636,31,14,0,24,329,1214
2004-06-11,168,634,31,14,0,24,329,1200
2004-06-10,169,622,32,14,0,24,330,1191
2004-06-09,180,619,33,14,0,25,329,1200
2004-06-08,179,615,33,14,0,26,328,1195
2004-06-07,179,622,33,14,0,27,333,1208
2004-06-04,179,620,33,14,0,27,333,1206
2004-06-03,178,622,31,14,0,27,330,1202
2004-06-02,174,638,31,14,0,27,333,1217
2004-06-01,170,642,32,13,0,26,316,1199
2004-05-31,150,636,31,14,0,26,316,1173
2004-05-28,162,637,31,12,0,27,323,1192
2004-05-27,161,636,31,12,0,26,321,1187
2004-05-26,158,633,31,13,0,25,321,1181
2004-05-24,158,636,31,13,0,25,323,1186
2004-05-21,157,638,31,13,0,24,322,1185
2004-05-20,156,635,31,13,0,24,324,1183
2004-05-19,155,630,31,13,0,24,325,1178
2004-05-18,155,630,31,13,0,24,323,1176
2004-05-17,154,657,31,13,0,24,323,1202
2004-05-14,153,657,31,13,0,23,324,1201
2004-05-13,153,656,31,13,0,23,325,1201
2004-05-12,153,657,31,13,0,22,324,1200
2004-05-11,153,645,31,13,0,24,321,1187
2004-05-10,153,640,31,11,0,24,324,1183
2004-05-07,150,644,31,11,0,24,325,1185
2004-05-06,150,640,30,11,0,24,322,1177
2004-05-05,150,643,31,11,0,25,323,1183
2004-05-04,150,643,31,11,0,25,324,1184
2004-05-03,149,639,31,11,0,26,324,1180
2004-04-30,149,643,31,11,0,26,324,1184
2004-04-29,151,637,31,11,0,26,329,1185
2004-04-28,149,638,31,11,0,25,324,1178
2004-04-27,149,646,29,11,0,25,324,1184
2004-04-26,149,649,29,11,0,25,335,1198
2004-04-23,144,657,29,11,0,25,334,1200
2004-04-22,144,653,29,11,0,24,335,1196
2004-04-21,144,655,29,11,0,24,334,1197
2004-04-20,144,655,29,11,0,23,335,1197
2004-04-19,143,654,29,11,0,24,335,1196
2004-04-16,143,656,29,11,0,24,333,1196
2004-04-15,143,655,29,11,0,24,332,1194
2004-04-14,142,660,29,11,0,25,334,1201
2004-04-13,142,663,29,11,0,26,334,1205
2004-04-12,142,663,29,11,0,26,332,1203
2004-04-07,142,663,28,11,0,26,332,1202
2004-04-06,137,666,28,11,0,29,332,1203
2004-04-02,137,668,28,11,0,27,332,1203
2004-04-01,134,669,28,11,0,27,333,1202
2004-03-31,133,663,28,11,0,27,344,1206
2004-03-30,134,665,28,9,0,27,342,1205
2004-03-29,134,666,28,9,0,27,340,1204
2004-03-26,133,663,28,9,0,27,339,1199
2004-03-25,128,662,28,9,0,27,293,1147
2004-03-24,137,662,28,9,0,27,294,1157
2004-03-23,137,658,28,9,0,26,294,1152
2004-03-22,138,677,29,9,0,27,446,1326
2004-03-19,136,669,29,9,0,27,448,1318
2004-03-18,130,669,29,9,0,26,447,1310
2004-03-17,130,671,28,9,0,24,448,1310
2004-03-16,130,662,28,9,0,25,447,1301
2004-03-15,130,674,28,9,0,24,446,1311
2004-03-12,131,682,28,9,0,25,448,1323
2004-03-11,130,685,28,10,0,25,447,1325
2004-03-10,130,682,28,9,0,26,449,1324
2004-03-09,130,682,28,9,0,27,447,1323
2004-03-08,130,675,28,9,0,29,446,1317
2004-03-05,130,675,28,9,0,29,447,1318
2004-03-04,131,675,28,9,0,29,447,1319
2004-03-03,126,674,28,9,0,29,450,1316
2004-03-02,126,674,28,9,0,29,452,1318
2004-03-01,125,674,28,9,0,30,452,1318
2004-02-27,124,671,29,9,0,30,452,1315
2004-02-26,125,672,28,13,0,30,453,1321
2004-02-25,125,674,28,13,0,30,453,1323
2004-02-24,125,671,28,13,0,30,455,1322
2004-02-23,126,673,28,13,0,30,454,1324
2004-02-20,128,673,28,13,0,29,451,1322
2004-02-19,132,673,28,13,0,26,452,1324
2004-02-18,132,678,28,12,0,26,452,1328
2004-02-17,131,678,28,13,0,26,451,1327
2004-02-16,131,676,28,13,0,27,451,1326
2004-02-13,131,674,28,13,0,27,446,1319
2004-02-12,130,673,29,18,0,27,447,1324
2004-02-11,130,668,29,18,0,27,447,1319
2004-02-10,130,672,29,18,0,29,447,1325
2004-02-09,130,676,29,18,0,30,447,1330
2004-02-06,130,678,29,18,0,29,447,1331
2004-02-05,130,677,29,18,0,29,448,1331
2004-02-04,129,678,29,18,0,29,449,1332
2004-02-03,130,678,29,18,0,29,448,1332
2004-02-02,132,679,29,19,0,30,448,1337
2004-01-30,131,675,29,19,0,30,449,1333
2004-01-29,132,689,29,19,0,29,448,1346
2004-01-28,132,683,29,19,0,28,448,1339
2004-01-27,131,683,29,19,0,27,448,1337
2004-01-26,131,680,29,19,0,25,446,1330
2004-01-23,131,678,29,19,0,24,446,1327
2004-01-22,131,675,29,19,0,23,448,1325
2004-01-21,129,674,29,19,0,23,444,1318
2004-01-20,130,670,29,19,0,22,444,1314
2004-01-19,129,669,29,19,0,22,444,1312
2004-01-16,129,660,29,19,0,21,443,1301
2004-01-15,128,661,29,19,0,21,443,1301
2004-01-14,128,652,29,19,0,21,442,1291
2004-01-13,128,648,29,19,0,21,443,1288
2004-01-12,130,632,29,19,0,23,443,1276
2004-01-09,136,628,29,19,0,23,446,1281
2004-01-08,135,627,29,19,0,22,442,1274
2004-01-07,136,633,29,19,0,22,443,1282
2004-01-06,128,630,29,19,0,22,442,1270
2004-01-05,128,635,29,18,0,23,446,1279
2004-01-02,133,629,29,19,0,23,446,1279
2003-12-31,122,612,29,19,0,21,458,1261
2003-12-30,141,667,29,19,0,21,443,1320
2003-12-29,141,667,28,19,0,21,435,1311
2003-12-26,138,668,28,19,0,21,429,1303
2003-12-24,141,677,28,19,0,20,429,1314
2003-12-23,140,678,28,19,0,20,428,1313
2003-12-22,140,681,28,19,0,20,442,1330
2003-12-19,142,682,28,19,0,20,443,1334
2003-12-18,139,679,28,19,0,20,442,1327
2003-12-17,141,677,27,19,0,20,448,1332
2003-12-16,141,682,28,18,0,20,449,1338
2003-12-15,140,676,28,18,0,20,448,1330
2003-12-12,135,675,27,18,0,20,446,1321
2003-12-11,135,676,28,18,0,20,447,1324
2003-12-10,135,675,28,18,0,20,448,1324
2003-12-09,135,674,28,18,0,22,442,1319
2003-12-05,135,671,28,18,0,22,441,1315
2003-12-04,135,673,28,18,0,22,442,1318
2003-12-03,135,669,28,18,0,22,443,1315
2003-12-02,135,669,28,18,0,22,442,1314
2003-12-01,136,638,28,18,0,23,448,1291
2003-11-28,131,664,27,19,0,24,458,1323
2003-11-27,132,672,28,18,0,22,443,1315
2003-11-26,132,670,15,18,0,23,443,1301
2003-11-25,132,688,10,18,0,23,453,1324
2003-11-24,132,688,10,18,0,22,444,1314
2003-11-21,132,691,10,18,0,22,443,1316
2003-11-20,130,689,10,18,0,20,440,1307
2003-11-19,128,688,10,18,0,20,437,1301
2003-11-18,127,681,10,18,0,19,437,1292
2003-11-17,127,683,10,18,0,19,444,1301
2003-11-14,127,679,10,18,0,20,438,1292
2003-11-13,128,686,10,18,0,20,437,1299
2003-11-12,126,687,10,18,0,20,437,1298
2003-11-11,128,686,10,18,0,21,437,1300
2003-11-10,129,686,10,18,0,22,436,1301
2003-11-07,132,688,10,18,0,22,429,1299
2003-11-05,132,689,10,18,0,23,429,1301
2003-11-04,134,684,10,18,0,23,428,1297
2003-11-03,135,682,11,18,0,24,429,1299
2003-10-31,128,675,10,18,0,23,450,1304
2003-10-30,134,667,11,18,0,23,432,1285
2003-10-29,134,667,11,18,0,22,433,1285
2003-10-28,135,661,11,18,0,22,431,1278
2003-10-27,135,663,11,18,0,21,431,1279
2003-10-24,135,664,11,18,0,21,440,1289
2003-10-23,136,661,11,18,0,21,435,1282
2003-10-22,136,662,11,18,0,20,434,1281
2003-10-21,132,657,11,18,0,20,436,1274
2003-10-20,133,656,11,18,0,20,435,1273
2003-10-17,132,651,11,18,0,20,434,1266
2003-10-16,132,653,11,18,0,20,434,1268
2003-10-15,132,655,11,18,0,23,434,1273
2003-10-14,132,654,11,18,0,22,431,1268
2003-10-10,131,654,11,18,0,23,434,1271
2003-10-09,131,657,11,21,0,22,434,1276
2003-10-08,130,648,11,21,0,23,434,1267
2003-10-07,130,657,11,21,0,22,431,1272
2003-10-06,128,658,11,21,0,23,433,1274
2003-10-03,128,648,11,21,0,23,446,1277
2003-10-02,113,641,11,21,0,21,442,1249
2003-10-01,113,641,11,21,0,21,443,1250
2003-09-30,109,661,11,18,0,21,435,1255
2003-09-29,120,647,11,21,0,23,436,1258
2003-09-26,122,648,11,21,0,21,432,1255
2003-09-25,122,659,11,21,0,20,435,1268
2003-09-24,122,652,11,21,0,19,448,1273
2003-09-23,122,649,11,21,0,18,434,1255
2003-09-22,124,650,11,21,0,17,437,1260
2003-09-19,123,644,11,22,0,17,443,1260
2003-09-18,124,646,11,22,0,17,438,1258
2003-09-17,123,644,11,22,0,16,439,1255
2003-09-16,123,639,11,22,0,16,446,1257
2003-09-15,122,642,11,22,0,16,444,1257
2003-09-12,121,643,11,22,0,16,442,1255
2003-09-11,121,644,11,22,0,15,442,1255
2003-09-10,121,644,11,22,0,15,442,1255
2003-09-09,123,642,11,22,0,16,442,1256
2003-09-08,123,639,11,20,0,17,441,1251
2003-09-05,123,636,11,20,0,17,442,1249
2003-09-04,123,635,11,20,0,17,442,1248
2003-09-03,123,636,11,20,0,17,441,1248
2003-09-02,124,633,11,20,0,17,449,1254
2003-09-01,123,633,11,20,0,17,448,1252
2003-08-29,117,648,11,20,0,18,450,1264
2003-08-28,122,655,11,20,0,18,449,1275
2003-08-27,125,652,11,20,0,17,459,1284
2003-08-26,125,652,11,20,0,17,460,1285
2003-08-25,127,647,11,20,0,16,450,1271
2003-08-22,131,648,11,20,0,16,449,1275
2003-08-21,131,648,11,22,0,16,450,1278
2003-08-20,130,649,11,22,0,16,452,1280
2003-08-19,131,648,11,22,0,16,454,1282
2003-08-15,131,646,11,22,0,16,453,1279
2003-08-14,132,644,11,22,0,16,456,1281
2003-08-13,132,644,11,22,0,17,450,1276
2003-08-12,133,642,11,22,0,18,450,1276
2003-08-11,133,637,11,22,0,19,451,1273
2003-08-08,133,637,11,22,0,20,450,1273
2003-08-07,130,637,11,22,0,20,450,1270
2003-08-06,130,647,11,22,0,19,450,1279
2003-08-05,129,652,10,22,0,19,451,1283
2003-08-04,127,649,10,22,0,20,452,1280
2003-08-01,127,648,10,22,0,20,457,1284
2003-07-31,123,659,10,22,0,21,461,1296
2003-07-30,139,649,11,22,0,19,471,1311
2003-07-29,141,654,11,22,0,19,469,1316
2003-07-28,142,655,11,22,0,19,467,1316
2003-07-25,138,656,11,22,0,18,473,1318
2003-07-24,140,677,11,22,0,18,471,1339
2003-07-23,140,677,11,22,0,18,473,1341
2003-07-22,138,676,11,22,0,18,472,1337
2003-07-21,138,671,11,22,0,17,473,1332
2003-07-18,137,672,11,22,0,17,480,1339
2003-07-17,139,674,11,22,0,17,482,1345
2003-07-16,139,672,11,22,0,17,482,1343
2003-07-15,139,674,16,22,0,17,480,1348
2003-07-14,139,676,16,22,0,17,473,1343
2003-07-11,140,678,16,22,0,17,473,1346
2003-07-10,139,677,16,22,0,18,474,1346
2003-07-08,141,679,16,22,0,18,473,1349
2003-07-07,142,675,16,22,0,19,482,1356
2003-07-04,142,681,16,22,0,19,481,1361
2003-07-03,142,682,16,22,0,17,475,1354
2003-07-02,142,669,16,22,0,17,463,1329
2003-07-01,143,677,16,22,0,17,466,1341
2003-06-30,122,682,16,22,0,18,466,1326
2003-06-27,142,655,17,22,0,18,466,1320
2003-06-26,141,673,17,22,0,17,469,1339
2003-06-25,141,672,23,22,0,17,464,1339
2003-06-24,141,671,24,22,0,17,467,1342
2003-06-23,142,685,24,22,0,17,469,1359
2003-06-20,142,685,24,22,0,16,480,1369
2003-06-19,141,683,24,22,0,16,476,1362
2003-06-18,141,685,24,22,0,15,468,1355
2003-06-17,141,682,24,22,0,15,470,1354
2003-06-13,141,683,24,22,0,15,470,1355
2003-06-12,141,684,24,22,0,15,470,1356
2003-06-11,142,679,24,28,0,16,470,1359
2003-06-10,141,679,24,27,0,17,473,1361
2003-06-09,139,680,24,27,0,17,473,1360
2003-06-06,139,675,25,27,0,18,475,1359
2003-06-05,139,667,25,27,0,18,480,1356
2003-06-04,142,670,25,27,0,18,480,1362
2003-06-03,146,670,25,27,0,18,476,1362
2003-06-02,149,672,25,27,0,18,474,1365
2003-05-30,127,675,25,27,0,18,463,1335
2003-05-29,146,666,25,27,0,18,478,1360
2003-05-28,146,667,25,27,0,18,473,1356
2003-05-27,146,668,26,27,0,18,486,1371
2003-05-26,147,670,26,27,0,17,479,1366
2003-05-23,148,671,26,27,0,17,480,1369
2003-05-22,149,669,26,27,0,18,480,1369
2003-05-21,149,669,26,27,0,17,481,1369
2003-05-20,149,669,26,27,0,18,474,1363
2003-05-19,148,663,26,27,0,15,476,1355
2003-05-16,145,663,26,27,0,15,498,1374
2003-05-15,146,661,26,27,0,15,509,1384
2003-05-14,145,664,26,27,0,16,509,1387
2003-05-13,143,664,26,27,0,16,510,1386
2003-05-12,143,664,26,27,0,17,510,1387
2003-05-09,144,665,26,27,0,18,510,1390
2003-05-08,144,665,26,27,0,17,509,1388
2003-05-07,146,672,26,27,0,18,496,1385
2003-05-06,146,671,26,26,0,18,507,1394
2003-05-05,147,676,24,26,0,19,516,1408
2003-05-02,146,675,24,26,0,19,505,1395
2003-04-30,131,679,24,27,0,16,502,1379
2003-04-29,158,674,24,27,0,18,508,1409
2003-04-28,157,675,24,27,0,18,510,1411
2003-04-25,160,671,24,27,0,18,468,1368
2003-04-24,162,673,24,27,0,17,456,1359
2003-04-23,162,673,24,27,0,17,453,1356
2003-04-22,161,672,24,27,0,17,457,1358
2003-04-21,164,672,24,27,0,17,458,1362
2003-04-16,167,678,24,27,0,17,460,1373
2003-04-15,164,676,24,27,0,17,460,1368
2003-04-14,165,674,24,27,0,17,462,1369
2003-04-11,165,674,24,27,0,17,458,1365
2003-04-10,164,673,24,27,0,17,460,1365
2003-04-09,165,675,24,27,0,17,460,1368
2003-04-08,166,675,24,27,0,18,455,1365
2003-04-07,166,673,24,27,0,18,458,1366
2003-04-04,166,674,24,27,0,19,460,1370
2003-04-03,166,676,24,27,0,19,455,1367
2003-04-02,166,668,26,28,0,16,462,1366
2003-04-01,172,665,26,28,0,16,462,1369
2003-03-28,135,677,24,28,0,16,498,1378
2003-03-27,169,663,26,28,0,17,462,1365
2003-03-26,169,662,27,28,0,17,459,1362
2003-03-25,170,667,27,28,0,16,458,1366
2003-03-24,170,650,27,28,0,16,481,1372
2003-03-21,170,650,27,28,0,16,478,1369
2003-03-20,172,650,27,28,0,16,479,1372
2003-03-19,174,651,27,28,0,16,481,1377
2003-03-18,177,650,27,28,0,16,485,1383
2003-03-17,177,650,27,28,1,16,484,1383
2003-03-14,177,650,27,28,1,16,484,1383
2003-03-13,177,650,27,28,1,16,483,1382
2003-03-12,177,650,27,28,1,15,484,1382
2003-03-11,177,649,27,28,1,15,486,1383
2003-03-10,177,652,27,28,1,16,488,1389
2003-03-07,172,652,27,28,1,16,485,1381
2003-03-06,172,652,27,28,1,21,486,1387
2003-03-05,173,652,27,28,1,17,488,1386
2003-03-04,175,657,27,28,1,17,487,1392
2003-03-03,176,657,27,28,1,17,486,1392
2003-02-28,145,631,25,27,0,17,523,1368
2003-02-27,175,665,27,28,1,17,485,1398
2003-02-26,190,649,27,28,1,17,484,1396
2003-02-25,190,655,28,28,1,16,483,1401
2003-02-24,191,653,27,28,1,16,483,1399
2003-02-21,190,654,27,28,1,16,483,1399
2003-02-20,190,663,27,28,1,15,486,1410
2003-02-19,191,663,27,28,1,14,484,1408
2003-02-18,191,663,27,28,1,14,489,1413
2003-02-17,191,659,27,28,1,14,495,1415
2003-02-14,189,660,27,28,1,14,499,1418
2003-02-13,192,659,27,28,1,14,494,1415
2003-02-12,191,642,27,28,1,15,494,1398
2003-02-11,191,641,27,28,1,16,492,1396
2003-02-10,191,642,27,28,2,17,492,1399
2003-02-07,190,641,27,28,1,16,491,1394
2003-02-06,188,631,27,29,1,16,490,1382
2003-02-05,188,633,27,29,1,17,492,1387
2003-02-04,190,608,27,29,1,16,502,1373
2003-02-03,188,609,27,29,1,17,492,1363
2003-01-31,158,647,25,28,1,17,534,1410
2003-01-30,217,591,27,29,1,16,499,1380
2003-01-29,222,595,27,29,1,16,492,1382
2003-01-28,220,598,27,29,1,16,496,1387
2003-01-27,222,594,27,29,1,15,491,1379
2003-01-24,220,592,27,29,1,15,490,1374
2003-01-23,217,594,27,29,1,14,490,1372
2003-01-22,215,587,27,29,1,14,490,1363
2003-01-21,218,590,27,29,1,14,493,1372
2003-01-20,217,590,27,29,1,14,490,1368
2003-01-17,218,593,27,29,1,13,490,1371
2003-01-16,221,601,29,29,1,13,487,1381
2003-01-15,221,600,27,29,1,12,485,1375
2003-01-14,221,608,27,29,1,12,485,1383
2003-01-13,221,606,27,29,1,12,487,1383
2003-01-10,219,602,27,35,1,12,486,1382
2003-01-09,220,603,30,34,1,11,486,1385
2003-01-08,222,599,33,35,1,12,488,1390
2003-01-07,222,599,33,35,1,12,494,1396
2003-01-06,222,600,33,35,1,12,503,1406
2003-01-03,221,605,30,35,1,12,503,1407
2003-01-02,221,634,33,35,1,12,496,1432
2002-12-31,174,584,29,33,0,12,541,1373
